Name	Result	Orig Len	Opt Len	Reduction	Pixels
svgs/W3C_SVG_11_TestSuite/svg/color-prof-01-f.svg	pass	3965	1348	2617	0
svgs/W3C_SVG_11_TestSuite/svg/color-prop-01-b.svg	pass	4128	1311	2817	0
svgs/W3C_SVG_11_TestSuite/svg/color-prop-02-f.svg	pass	6324	2181	4143	0
svgs/W3C_SVG_11_TestSuite/svg/color-prop-03-t.svg	pass	5422	1803	3619	0
svgs/W3C_SVG_11_TestSuite/svg/color-prop-04-t.svg	mismatch	5806	3203	2603	2767
svgs/W3C_SVG_11_TestSuite/svg/color-prop-05-t.svg	pass	3175	821	2354	0
svgs/W3C_SVG_11_TestSuite/svg/conform-viewers-01-t.svg	pass	11052	2784	8268	0
svgs/W3C_SVG_11_TestSuite/svg/conform-viewers-02-f.svg	pass	4070	1916	2154	0
svgs/W3C_SVG_11_TestSuite/svg/conform-viewers-03-f.svg	pass	5484	2795	2689	0
svgs/W3C_SVG_11_TestSuite/svg/coords-coord-01-t.svg	pass	3619	995	2624	0
svgs/W3C_SVG_11_TestSuite/svg/coords-coord-02-t.svg	pass	3628	995	2633	0
svgs/W3C_SVG_11_TestSuite/svg/coords-dom-01-f.svg	pass	4300	2431	1869	0
svgs/W3C_SVG_11_TestSuite/svg/coords-dom-02-f.svg	pass	3595	1631	1964	0
svgs/W3C_SVG_11_TestSuite/svg/coords-dom-03-f.svg	pass	4904	2520	2384	0
svgs/W3C_SVG_11_TestSuite/svg/coords-dom-04-f.svg	pass	6387	1116	5271	0
svgs/W3C_SVG_11_TestSuite/svg/coords-trans-01-b.svg	pass	12864	3696	9168	0
svgs/W3C_SVG_11_TestSuite/svg/coords-trans-02-t.svg	pass	9961	1368	8593	0
svgs/W3C_SVG_11_TestSuite/svg/coords-trans-03-t.svg	pass	5473	1381	4092	0
svgs/W3C_SVG_11_TestSuite/svg/coords-trans-04-t.svg	pass	4908	1083	3825	0
svgs/W3C_SVG_11_TestSuite/svg/coords-trans-05-t.svg	pass	4953	1102	3851	0
svgs/W3C_SVG_11_TestSuite/svg/coords-trans-06-t.svg	pass	4192	1107	3085	0
svgs/W3C_SVG_11_TestSuite/svg/coords-trans-07-t.svg	pass	3913	1183	2730	0
svgs/W3C_SVG_11_TestSuite/svg/coords-trans-08-t.svg	pass	4128	1320	2808	0
svgs/W3C_SVG_11_TestSuite/svg/coords-trans-09-t.svg	pass	4892	1829	3063	0
svgs/W3C_SVG_11_TestSuite/svg/coords-trans-10-f.svg	pass	4346	1633	2713	0
svgs/W3C_SVG_11_TestSuite/svg/coords-trans-11-f.svg	pass	4354	1645	2709	0
svgs/W3C_SVG_11_TestSuite/svg/coords-trans-12-f.svg	pass	4405	1639	2766	0
svgs/W3C_SVG_11_TestSuite/svg/coords-trans-13-f.svg	pass	4286	1627	2659	0
svgs/W3C_SVG_11_TestSuite/svg/coords-trans-14-f.svg	pass	4458	1749	2709	0
svgs/W3C_SVG_11_TestSuite/svg/coords-transformattr-01-f.svg	pass	5001	1880	3121	0
svgs/W3C_SVG_11_TestSuite/svg/coords-transformattr-02-f.svg	pass	4527	1486	3041	0
svgs/W3C_SVG_11_TestSuite/svg/coords-transformattr-03-f.svg	pass	3794	1172	2622	0
svgs/W3C_SVG_11_TestSuite/svg/coords-transformattr-04-f.svg	pass	3551	1160	2391	0
svgs/W3C_SVG_11_TestSuite/svg/coords-transformattr-05-f.svg	pass	4382	1240	3142	0
svgs/W3C_SVG_11_TestSuite/svg/coords-units-01-b.svg	pass	11342	4084	7258	0
svgs/W3C_SVG_11_TestSuite/svg/coords-units-02-b.svg	pass	8314	1813	6501	0
svgs/W3C_SVG_11_TestSuite/svg/coords-units-03-b.svg	mismatch	9072	2217	6855	394
svgs/W3C_SVG_11_TestSuite/svg/coords-viewattr-01-b.svg	pass	8509	8391	118	0
svgs/W3C_SVG_11_TestSuite/svg/coords-viewattr-02-b.svg	pass	53178	50381	2797	0
svgs/W3C_SVG_11_TestSuite/svg/coords-viewattr-03-b.svg	pass	6064	3698	2366	0
svgs/W3C_SVG_11_TestSuite/svg/coords-viewattr-04-f.svg	pass	7005	4634	2371	0
svgs/W3C_SVG_11_TestSuite/svg/extend-namespace-01-f.svg	pass	8597	1845	6752	0
svgs/W3C_SVG_11_TestSuite/svg/filters-background-01-f.svg	pass	8484	3168	5316	0
svgs/W3C_SVG_11_TestSuite/svg/filters-blend-01-b.svg	pass	6769	3486	3283	0
svgs/W3C_SVG_11_TestSuite/svg/filters-color-01-b.svg	pass	6533	2970	3563	0
svgs/W3C_SVG_11_TestSuite/svg/filters-color-02-b.svg	pass	5593	1719	3874	0
svgs/W3C_SVG_11_TestSuite/svg/filters-composite-02-b.svg	pass	9284	5263	4021	4
svgs/W3C_SVG_11_TestSuite/svg/filters-composite-03-f.svg	pass	4521	2042	2479	0
svgs/W3C_SVG_11_TestSuite/svg/filters-composite-04-f.svg	pass	4314	2338	1976	0
svgs/W3C_SVG_11_TestSuite/svg/filters-comptran-01-b.svg	pass	6826	3109	3717	0
svgs/W3C_SVG_11_TestSuite/svg/filters-conv-01-f.svg	pass	6835	3548	3287	0
svgs/W3C_SVG_11_TestSuite/svg/filters-conv-02-f.svg	pass	4243	2031	2212	0
svgs/W3C_SVG_11_TestSuite/svg/filters-conv-03-f.svg	pass	5246	2746	2500	0
svgs/W3C_SVG_11_TestSuite/svg/filters-conv-04-f.svg	pass	8527	3140	5387	0
svgs/W3C_SVG_11_TestSuite/svg/filters-diffuse-01-f.svg	pass	8988	4234	4754	0
svgs/W3C_SVG_11_TestSuite/svg/filters-displace-01-f.svg	mismatch	7173	3120	4053	1172
svgs/W3C_SVG_11_TestSuite/svg/filters-displace-02-f.svg	pass	5267	1800	3467	0
svgs/W3C_SVG_11_TestSuite/svg/filters-example-01-b.svg	pass	5037	1741	3296	0
svgs/W3C_SVG_11_TestSuite/svg/filters-felem-01-b.svg	pass	4743	1634	3109	0
svgs/W3C_SVG_11_TestSuite/svg/filters-felem-02-f.svg	pass	6255	3527	2728	0
svgs/W3C_SVG_11_TestSuite/svg/filters-gauss-01-b.svg	pass	4927	1553	3374	4
svgs/W3C_SVG_11_TestSuite/svg/filters-gauss-02-f.svg	pass	4010	1500	2510	0
svgs/W3C_SVG_11_TestSuite/svg/filters-gauss-03-f.svg	pass	3036	1117	1919	0
svgs/W3C_SVG_11_TestSuite/svg/filters-image-01-b.svg	pass	3094	1113	1981	0
svgs/W3C_SVG_11_TestSuite/svg/filters-image-02-b.svg	pass	3817	1436	2381	0
svgs/W3C_SVG_11_TestSuite/svg/filters-image-03-f.svg	pass	8286	2672	5614	0
svgs/W3C_SVG_11_TestSuite/svg/filters-image-04-f.svg	pass	6359	3043	3316	0
svgs/W3C_SVG_11_TestSuite/svg/filters-image-05-f.svg	pass	10170	5076	5094	0
svgs/W3C_SVG_11_TestSuite/svg/filters-light-01-f.svg	pass	11316	6088	5228	0
svgs/W3C_SVG_11_TestSuite/svg/filters-light-02-f.svg	pass	5061	2392	2669	0
svgs/W3C_SVG_11_TestSuite/svg/filters-light-03-f.svg	pass	6747	2993	3754	0
svgs/W3C_SVG_11_TestSuite/svg/filters-light-05-f.svg	pass	14645	7432	7213	0
svgs/W3C_SVG_11_TestSuite/svg/filters-morph-01-f.svg	pass	6101	2940	3161	0
svgs/W3C_SVG_11_TestSuite/svg/filters-offset-01-b.svg	pass	5516	1884	3632	0
svgs/W3C_SVG_11_TestSuite/svg/filters-offset-02-b.svg	pass	4148	2030	2118	0
svgs/W3C_SVG_11_TestSuite/svg/filters-overview-01-b.svg	pass	8871	4425	4446	0
svgs/W3C_SVG_11_TestSuite/svg/filters-overview-02-b.svg	pass	9644	5173	4471	0
svgs/W3C_SVG_11_TestSuite/svg/filters-overview-03-b.svg	pass	8962	4906	4056	0
svgs/W3C_SVG_11_TestSuite/svg/filters-specular-01-f.svg	pass	12017	5822	6195	0
svgs/W3C_SVG_11_TestSuite/svg/filters-tile-01-b.svg	pass	4736	1344	3392	0
svgs/W3C_SVG_11_TestSuite/svg/filters-turb-01-f.svg	pass	5779	2966	2813	0
svgs/W3C_SVG_11_TestSuite/svg/filters-turb-02-f.svg	pass	7575	4049	3526	0
svgs/W3C_SVG_11_TestSuite/svg/fonts-desc-01-t.svg	pass	5673	1143	4530	0
svgs/W3C_SVG_11_TestSuite/svg/fonts-desc-02-t.svg	pass	7873	1589	6284	0
svgs/W3C_SVG_11_TestSuite/svg/fonts-desc-03-t.svg	pass	6131	1154	4977	0
svgs/W3C_SVG_11_TestSuite/svg/fonts-desc-04-t.svg	pass	7704	1462	6242	0
svgs/W3C_SVG_11_TestSuite/svg/fonts-desc-05-t.svg	pass	7907	1930	5977	0
svgs/W3C_SVG_11_TestSuite/svg/fonts-elem-01-t.svg	pass	11660	5011	6649	0
svgs/W3C_SVG_11_TestSuite/svg/fonts-elem-02-t.svg	pass	13985	8067	5918	0
svgs/W3C_SVG_11_TestSuite/svg/fonts-elem-03-b.svg	pass	8679	5021	3658	0
svgs/W3C_SVG_11_TestSuite/svg/fonts-elem-04-b.svg	pass	8624	5334	3290	0
svgs/W3C_SVG_11_TestSuite/svg/fonts-elem-05-t.svg	pass	6873	2001	4872	0
svgs/W3C_SVG_11_TestSuite/svg/fonts-elem-06-t.svg	pass	5987	1598	4389	0
svgs/W3C_SVG_11_TestSuite/svg/fonts-elem-07-b.svg	pass	12091	7549	4542	0
svgs/W3C_SVG_11_TestSuite/svg/fonts-glyph-02-t.svg	pass	7417	928	6489	0
svgs/W3C_SVG_11_TestSuite/svg/fonts-glyph-03-t.svg	pass	4332	1133	3199	0
svgs/W3C_SVG_11_TestSuite/svg/fonts-glyph-04-t.svg	pass	3808	874	2934	0
svgs/W3C_SVG_11_TestSuite/svg/fonts-kern-01-t.svg	mismatch	14696	4524	10172	1852
svgs/W3C_SVG_11_TestSuite/svg/fonts-overview-201-t.svg	pass	7027	1282	5745	0
svgs/W3C_SVG_11_TestSuite/svg/imp-path-01-f.svg	pass	2870	1174	1696	0
svgs/W3C_SVG_11_TestSuite/svg/interact-cursor-01-f.svg	pass	8733	3474	5259	0
svgs/W3C_SVG_11_TestSuite/svg/interact-dom-01-b.svg	pass	5967	2842	3125	0
svgs/W3C_SVG_11_TestSuite/svg/interact-events-01-b.svg	pass	6264	1911	4353	0
svgs/W3C_SVG_11_TestSuite/svg/interact-events-02-b.svg	pass	3816	1669	2147	0
svgs/W3C_SVG_11_TestSuite/svg/interact-events-202-f.svg	pass	4040	1637	2403	0
svgs/W3C_SVG_11_TestSuite/svg/interact-events-203-t.svg	pass	6589	2842	3747	0
svgs/W3C_SVG_11_TestSuite/svg/interact-order-01-b.svg	pass	4974	1724	3250	0
svgs/W3C_SVG_11_TestSuite/svg/interact-order-02-b.svg	pass	4738	1720	3018	0
svgs/W3C_SVG_11_TestSuite/svg/interact-order-03-b.svg	pass	4562	1716	2846	0
svgs/W3C_SVG_11_TestSuite/svg/interact-pevents-01-b.svg	mismatch	12139	8527	3612	79
svgs/W3C_SVG_11_TestSuite/svg/interact-pevents-03-b.svg	pass	12221	2004	10217	0
svgs/W3C_SVG_11_TestSuite/svg/interact-pevents-04-t.svg	pass	12416	2075	10341	0
svgs/W3C_SVG_11_TestSuite/svg/interact-pevents-05-b.svg	pass	9190	1436	7754	0
svgs/W3C_SVG_11_TestSuite/svg/interact-pevents-07-t.svg	pass	7310	4684	2626	0
svgs/W3C_SVG_11_TestSuite/svg/interact-pevents-08-f.svg	pass	14175	8951	5224	0
svgs/W3C_SVG_11_TestSuite/svg/interact-pevents-09-f.svg	pass	13782	8858	4924	0
svgs/W3C_SVG_11_TestSuite/svg/interact-pevents-10-f.svg	pass	3891	1387	2504	0
svgs/W3C_SVG_11_TestSuite/svg/interact-pointer-01-t.svg	pass	3991	1848	2143	0
svgs/W3C_SVG_11_TestSuite/svg/interact-pointer-02-t.svg	pass	3957	1842	2115	0
svgs/W3C_SVG_11_TestSuite/svg/interact-pointer-03-t.svg	pass	3868	1647	2221	0
svgs/W3C_SVG_11_TestSuite/svg/interact-pointer-04-f.svg	pass	4104	2019	2085	0
svgs/W3C_SVG_11_TestSuite/svg/interact-zoom-01-t.svg	pass	3656	1095	2561	0
svgs/W3C_SVG_11_TestSuite/svg/interact-zoom-02-t.svg	pass	3660	1107	2553	0
svgs/W3C_SVG_11_TestSuite/svg/interact-zoom-03-t.svg	pass	3719	1191	2528	0
svgs/W3C_SVG_11_TestSuite/svg/linking-a-01-b.svg	pass	4209	962	3247	0
svgs/W3C_SVG_11_TestSuite/svg/linking-a-03-b.svg	pass	4316	984	3332	0
svgs/W3C_SVG_11_TestSuite/svg/linking-a-04-t.svg	pass	6414	1448	4966	0
svgs/W3C_SVG_11_TestSuite/svg/linking-a-05-t.svg	pass	5740	1973	3767	0
svgs/W3C_SVG_11_TestSuite/svg/linking-a-07-t.svg	pass	5860	1910	3950	0
svgs/W3C_SVG_11_TestSuite/svg/linking-a-08-t.svg	pass	3214	1042	2172	0
svgs/W3C_SVG_11_TestSuite/svg/linking-a-09-b.svg	mismatch	3418	1194	2224	10
svgs/W3C_SVG_11_TestSuite/svg/linking-a-10-f.svg	pass	4392	1878	2514	0
svgs/W3C_SVG_11_TestSuite/svg/linking-frag-01-f.svg	pass	3761	1581	2180	0
svgs/W3C_SVG_11_TestSuite/svg/linking-uri-01-b.svg	pass	8847	2805	6042	0
svgs/W3C_SVG_11_TestSuite/svg/linking-uri-02-b.svg	pass	9537	2892	6645	0
svgs/W3C_SVG_11_TestSuite/svg/linking-uri-03-t.svg	pass	5464	1988	3476	0
svgs/W3C_SVG_11_TestSuite/svg/masking-filter-01-f.svg	pass	4003	1326	2677	0
svgs/W3C_SVG_11_TestSuite/svg/masking-intro-01-f.svg	pass	4354	1713	2641	0
svgs/W3C_SVG_11_TestSuite/svg/masking-mask-01-b.svg	pass	7247	2773	4474	0
svgs/W3C_SVG_11_TestSuite/svg/masking-mask-02-f.svg	pass	2805	887	1918	0
svgs/W3C_SVG_11_TestSuite/svg/masking-opacity-01-b.svg	pass	5995	2147	3848	0
svgs/W3C_SVG_11_TestSuite/svg/masking-path-01-b.svg	pass	5047	1550	3497	0
svgs/W3C_SVG_11_TestSuite/svg/masking-path-02-b.svg	pass	4541	1493	3048	0
svgs/W3C_SVG_11_TestSuite/svg/masking-path-03-b.svg	pass	6772	2188	4584	0
svgs/W3C_SVG_11_TestSuite/svg/masking-path-04-b.svg	pass	3995	1339	2656	0
svgs/W3C_SVG_11_TestSuite/svg/masking-path-05-f.svg	pass	4088	1313	2775	0
svgs/W3C_SVG_11_TestSuite/svg/masking-path-06-b.svg	pass	3862	1822	2040	0
svgs/W3C_SVG_11_TestSuite/svg/masking-path-07-b.svg	pass	6905	2230	4675	0
svgs/W3C_SVG_11_TestSuite/svg/masking-path-08-b.svg	pass	5760	2765	2995	0
svgs/W3C_SVG_11_TestSuite/svg/masking-path-09-b.svg	pass	3211	1327	1884	0
svgs/W3C_SVG_11_TestSuite/svg/masking-path-10-b.svg	pass	5544	2602	2942	0
svgs/W3C_SVG_11_TestSuite/svg/masking-path-11-b.svg	pass	3116	1084	2032	0
svgs/W3C_SVG_11_TestSuite/svg/masking-path-12-f.svg	pass	3855	1914	1941	0
svgs/W3C_SVG_11_TestSuite/svg/masking-path-13-f.svg	pass	2801	761	2040	0
svgs/W3C_SVG_11_TestSuite/svg/masking-path-14-f.svg	pass	4238	1171	3067	0
svgs/W3C_SVG_11_TestSuite/svg/metadata-example-01-t.svg	pass	21675	18152	3523	0
svgs/W3C_SVG_11_TestSuite/svg/painting-control-01-f.svg	pass	5238	2189	3049	0
svgs/W3C_SVG_11_TestSuite/svg/painting-control-02-f.svg	pass	3497	1128	2369	0
svgs/W3C_SVG_11_TestSuite/svg/painting-control-03-f.svg	pass	3400	994	2406	0
svgs/W3C_SVG_11_TestSuite/svg/painting-control-04-f.svg	pass	2939	930	2009	0
svgs/W3C_SVG_11_TestSuite/svg/painting-control-05-f.svg	pass	5839	1719	4120	0
svgs/W3C_SVG_11_TestSuite/svg/painting-control-06-f.svg	pass	3408	915	2493	0
svgs/W3C_SVG_11_TestSuite/svg/painting-fill-01-t.svg	pass	3551	1103	2448	0
svgs/W3C_SVG_11_TestSuite/svg/painting-fill-02-t.svg	pass	3711	1265	2446	0
svgs/W3C_SVG_11_TestSuite/svg/painting-fill-03-t.svg	pass	3488	1139	2349	0
svgs/W3C_SVG_11_TestSuite/svg/painting-fill-04-t.svg	pass	4352	1051	3301	0
svgs/W3C_SVG_11_TestSuite/svg/painting-fill-05-b.svg	pass	4502	1475	3027	0
svgs/W3C_SVG_11_TestSuite/svg/painting-marker-01-f.svg	pass	10160	2842	7318	0
svgs/W3C_SVG_11_TestSuite/svg/painting-marker-02-f.svg	pass	13254	4086	9168	0
svgs/W3C_SVG_11_TestSuite/svg/painting-marker-03-f.svg	pass	5040	2011	3029	0
svgs/W3C_SVG_11_TestSuite/svg/painting-marker-04-f.svg	pass	4984	1962	3022	0
svgs/W3C_SVG_11_TestSuite/svg/painting-marker-05-f.svg	pass	12550	8296	4254	0
svgs/W3C_SVG_11_TestSuite/svg/painting-marker-06-f.svg	pass	9894	2807	7087	0
svgs/W3C_SVG_11_TestSuite/svg/painting-marker-07-f.svg	pass	3322	1080	2242	0
svgs/W3C_SVG_11_TestSuite/svg/painting-marker-properties-01-f.svg	pass	4618	2014	2604	0
svgs/W3C_SVG_11_TestSuite/svg/painting-render-01-b.svg	pass	8956	4000	4956	0
svgs/W3C_SVG_11_TestSuite/svg/painting-render-02-b.svg	pass	4742	1714	3028	0
svgs/W3C_SVG_11_TestSuite/svg/painting-stroke-01-t.svg	pass	3899	1115	2784	0
svgs/W3C_SVG_11_TestSuite/svg/painting-stroke-02-t.svg	pass	3727	1182	2545	0
svgs/W3C_SVG_11_TestSuite/svg/painting-stroke-03-t.svg	pass	3758	1214	2544	0
svgs/W3C_SVG_11_TestSuite/svg/painting-stroke-04-t.svg	pass	3827	1280	2547	0
svgs/W3C_SVG_11_TestSuite/svg/painting-stroke-05-t.svg	pass	5369	2366	3003	0
svgs/W3C_SVG_11_TestSuite/svg/painting-stroke-06-t.svg	pass	4032	1324	2708	0
svgs/W3C_SVG_11_TestSuite/svg/painting-stroke-07-t.svg	pass	3855	1240	2615	0
svgs/W3C_SVG_11_TestSuite/svg/painting-stroke-08-t.svg	pass	4737	2152	2585	0
svgs/W3C_SVG_11_TestSuite/svg/painting-stroke-09-t.svg	pass	3245	872	2373	0
svgs/W3C_SVG_11_TestSuite/svg/painting-stroke-10-t.svg	pass	3559	1270	2289	0
svgs/W3C_SVG_11_TestSuite/svg/paths-data-01-t.svg	pass	11078	2589	8489	0
svgs/W3C_SVG_11_TestSuite/svg/paths-data-02-t.svg	pass	8577	2525	6052	0
svgs/W3C_SVG_11_TestSuite/svg/paths-data-03-f.svg	pass	8433	2300	6133	0
svgs/W3C_SVG_11_TestSuite/svg/paths-data-04-t.svg	pass	5482	1742	3740	0
svgs/W3C_SVG_11_TestSuite/svg/paths-data-05-t.svg	pass	5328	1665	3663	0
svgs/W3C_SVG_11_TestSuite/svg/paths-data-06-t.svg	pass	5520	1648	3872	0
svgs/W3C_SVG_11_TestSuite/svg/paths-data-07-t.svg	pass	5448	1655	3793	0
svgs/W3C_SVG_11_TestSuite/svg/paths-data-08-t.svg	pass	5355	1614	3741	0
svgs/W3C_SVG_11_TestSuite/svg/paths-data-09-t.svg	pass	5268	1485	3783	0
svgs/W3C_SVG_11_TestSuite/svg/paths-data-10-t.svg	pass	5896	2996	2900	0
svgs/W3C_SVG_11_TestSuite/svg/paths-data-12-t.svg	pass	3945	1134	2811	0
svgs/W3C_SVG_11_TestSuite/svg/paths-data-13-t.svg	pass	3149	852	2297	0
svgs/W3C_SVG_11_TestSuite/svg/paths-data-14-t.svg	pass	3628	993	2635	0
svgs/W3C_SVG_11_TestSuite/svg/paths-data-15-t.svg	pass	3555	999	2556	0
svgs/W3C_SVG_11_TestSuite/svg/paths-data-16-t.svg	pass	3273	1083	2190	0
svgs/W3C_SVG_11_TestSuite/svg/paths-data-17-f.svg	pass	3309	1019	2290	0
svgs/W3C_SVG_11_TestSuite/svg/paths-data-18-f.svg	pass	4726	2166	2560	0
svgs/W3C_SVG_11_TestSuite/svg/paths-data-19-f.svg	pass	5939	2358	3581	0
svgs/W3C_SVG_11_TestSuite/svg/paths-data-20-f.svg	pass	4243	1642	2601	0
svgs/W3C_SVG_11_TestSuite/svg/paths-dom-01-f.svg	pass	6828	4212	2616	0
svgs/W3C_SVG_11_TestSuite/svg/paths-dom-02-f.svg	pass	9645	7205	2440	0
svgs/W3C_SVG_11_TestSuite/svg/pservers-grad-01-b.svg	pass	3902	1256	2646	0
svgs/W3C_SVG_11_TestSuite/svg/pservers-grad-02-b.svg	pass	4696	1325	3371	0
svgs/W3C_SVG_11_TestSuite/svg/pservers-grad-03-b.svg	pass	4428	1345	3083	0
svgs/W3C_SVG_11_TestSuite/svg/pservers-grad-04-b.svg	pass	5034	1659	3375	0
svgs/W3C_SVG_11_TestSuite/svg/pservers-grad-05-b.svg	pass	5501	1766	3735	0
svgs/W3C_SVG_11_TestSuite/svg/pservers-grad-06-b.svg	pass	6668	1868	4800	0
svgs/W3C_SVG_11_TestSuite/svg/pservers-grad-07-b.svg	pass	5130	1258	3872	0
svgs/W3C_SVG_11_TestSuite/svg/pservers-grad-08-b.svg	pass	5472	1612	3860	0
svgs/W3C_SVG_11_TestSuite/svg/pservers-grad-09-b.svg	pass	6779	1477	5302	0
svgs/W3C_SVG_11_TestSuite/svg/pservers-grad-10-b.svg	pass	5644	1763	3881	0
svgs/W3C_SVG_11_TestSuite/svg/pservers-grad-11-b.svg	pass	7514	2276	5238	0
svgs/W3C_SVG_11_TestSuite/svg/pservers-grad-12-b.svg	pass	6758	2047	4711	0
svgs/W3C_SVG_11_TestSuite/svg/pservers-grad-13-b.svg	pass	9242	5843	3399	0
svgs/W3C_SVG_11_TestSuite/svg/pservers-grad-14-b.svg	pass	6443	3230	3213	0
svgs/W3C_SVG_11_TestSuite/svg/pservers-grad-15-b.svg	pass	3773	1129	2644	0
svgs/W3C_SVG_11_TestSuite/svg/pservers-grad-16-b.svg	pass	4408	1371	3037	0
svgs/W3C_SVG_11_TestSuite/svg/pservers-grad-17-b.svg	pass	5433	1962	3471	0
svgs/W3C_SVG_11_TestSuite/svg/pservers-grad-20-b.svg	pass	4961	1960	3001	0
svgs/W3C_SVG_11_TestSuite/svg/pservers-grad-21-b.svg	pass	6614	3270	3344	0
svgs/W3C_SVG_11_TestSuite/svg/pservers-grad-22-b.svg	pass	4269	2014	2255	0
svgs/W3C_SVG_11_TestSuite/svg/pservers-grad-23-f.svg	pass	3835	1266	2569	0
svgs/W3C_SVG_11_TestSuite/svg/pservers-grad-24-f.svg	pass	3598	1163	2435	0
svgs/W3C_SVG_11_TestSuite/svg/pservers-grad-stops-01-f.svg	pass	3846	1613	2233	0
svgs/W3C_SVG_11_TestSuite/svg/pservers-pattern-01-b.svg	pass	6524	2366	4158	0
svgs/W3C_SVG_11_TestSuite/svg/pservers-pattern-02-f.svg	pass	2939	964	1975	0
svgs/W3C_SVG_11_TestSuite/svg/pservers-pattern-03-f.svg	pass	4585	1872	2713	0
svgs/W3C_SVG_11_TestSuite/svg/pservers-pattern-04-f.svg	pass	3652	1141	2511	0
svgs/W3C_SVG_11_TestSuite/svg/pservers-pattern-05-f.svg	pass	3492	1322	2170	0
svgs/W3C_SVG_11_TestSuite/svg/pservers-pattern-06-f.svg	pass	3273	1068	2205	0
svgs/W3C_SVG_11_TestSuite/svg/pservers-pattern-07-f.svg	pass	3419	1442	1977	0
svgs/W3C_SVG_11_TestSuite/svg/pservers-pattern-08-f.svg	pass	3413	1381	2032	0
svgs/W3C_SVG_11_TestSuite/svg/pservers-pattern-09-f.svg	pass	3684	1420	2264	0
svgs/W3C_SVG_11_TestSuite/svg/render-elems-01-t.svg	pass	3337	978	2359	0
svgs/W3C_SVG_11_TestSuite/svg/render-elems-02-t.svg	pass	3403	1054	2349	0
svgs/W3C_SVG_11_TestSuite/svg/render-elems-03-t.svg	pass	3513	1062	2451	0
svgs/W3C_SVG_11_TestSuite/svg/render-elems-06-t.svg	pass	3658	1222	2436	0
svgs/W3C_SVG_11_TestSuite/svg/render-elems-07-t.svg	pass	3619	1239	2380	0
svgs/W3C_SVG_11_TestSuite/svg/render-elems-08-t.svg	pass	3684	1299	2385	0
svgs/W3C_SVG_11_TestSuite/svg/render-groups-01-b.svg	pass	6746	1585	5161	0
svgs/W3C_SVG_11_TestSuite/svg/render-groups-03-t.svg	pass	6038	1551	4487	0
svgs/W3C_SVG_11_TestSuite/svg/script-handle-01-b.svg	pass	4514	1629	2885	0
svgs/W3C_SVG_11_TestSuite/svg/script-handle-02-b.svg	pass	5731	2523	3208	0
svgs/W3C_SVG_11_TestSuite/svg/script-handle-03-b.svg	pass	5504	2279	3225	0
svgs/W3C_SVG_11_TestSuite/svg/script-handle-04-b.svg	pass	5585	2299	3286	0
svgs/W3C_SVG_11_TestSuite/svg/script-specify-01-f.svg	pass	3581	1550	2031	0
svgs/W3C_SVG_11_TestSuite/svg/script-specify-02-f.svg	pass	3614	1377	2237	0
svgs/W3C_SVG_11_TestSuite/svg/shapes-circle-01-t.svg	pass	3192	1173	2019	0
svgs/W3C_SVG_11_TestSuite/svg/shapes-circle-02-t.svg	pass	3235	895	2340	0
svgs/W3C_SVG_11_TestSuite/svg/shapes-ellipse-01-t.svg	pass	4439	1268	3171	0
svgs/W3C_SVG_11_TestSuite/svg/shapes-ellipse-02-t.svg	pass	3197	868	2329	0
svgs/W3C_SVG_11_TestSuite/svg/shapes-ellipse-03-f.svg	pass	3815	1002	2813	0
svgs/W3C_SVG_11_TestSuite/svg/shapes-grammar-01-f.svg	pass	3330	1078	2252	0
svgs/W3C_SVG_11_TestSuite/svg/shapes-intro-01-t.svg	pass	6517	1435	5082	0
svgs/W3C_SVG_11_TestSuite/svg/shapes-intro-02-f.svg	pass	4849	2167	2682	0
svgs/W3C_SVG_11_TestSuite/svg/shapes-line-01-t.svg	pass	4390	1488	2902	0
svgs/W3C_SVG_11_TestSuite/svg/shapes-line-02-f.svg	pass	2758	853	1905	0
svgs/W3C_SVG_11_TestSuite/svg/shapes-polygon-01-t.svg	pass	4842	1329	3513	0
svgs/W3C_SVG_11_TestSuite/svg/shapes-polygon-02-t.svg	pass	4184	1550	2634	0
svgs/W3C_SVG_11_TestSuite/svg/shapes-polygon-03-t.svg	pass	3159	1088	2071	0
svgs/W3C_SVG_11_TestSuite/svg/shapes-polyline-01-t.svg	pass	5435	1312	4123	0
svgs/W3C_SVG_11_TestSuite/svg/shapes-polyline-02-t.svg	pass	4328	1468	2860	0
svgs/W3C_SVG_11_TestSuite/svg/shapes-rect-01-t.svg	pass	4641	1338	3303	0
svgs/W3C_SVG_11_TestSuite/svg/shapes-rect-02-t.svg	pass	3380	941	2439	0
svgs/W3C_SVG_11_TestSuite/svg/shapes-rect-03-t.svg	pass	6546	3719	2827	0
svgs/W3C_SVG_11_TestSuite/svg/shapes-rect-04-f.svg	pass	3396	1041	2355	0
svgs/W3C_SVG_11_TestSuite/svg/shapes-rect-05-f.svg	pass	4015	1173	2842	0
svgs/W3C_SVG_11_TestSuite/svg/shapes-rect-06-f.svg	pass	3562	1308	2254	0
svgs/W3C_SVG_11_TestSuite/svg/shapes-rect-07-f.svg	pass	2921	1012	1909	0
svgs/W3C_SVG_11_TestSuite/svg/struct-cond-01-t.svg	pass	3230	967	2263	0
svgs/W3C_SVG_11_TestSuite/svg/struct-cond-02-t.svg	pass	24993	14477	10516	0
svgs/W3C_SVG_11_TestSuite/svg/struct-cond-03-t.svg	mismatch	4189	1355	2834	6
svgs/W3C_SVG_11_TestSuite/svg/struct-cond-overview-02-f.svg	pass	4062	1595	2467	0
svgs/W3C_SVG_11_TestSuite/svg/struct-cond-overview-03-f.svg	pass	3347	1239	2108	0
svgs/W3C_SVG_11_TestSuite/svg/struct-cond-overview-04-f.svg	pass	3443	1218	2225	0
svgs/W3C_SVG_11_TestSuite/svg/struct-cond-overview-05-f.svg	pass	3821	1499	2322	0
svgs/W3C_SVG_11_TestSuite/svg/struct-defs-01-t.svg	pass	3513	807	2706	0
svgs/W3C_SVG_11_TestSuite/svg/struct-dom-01-b.svg	pass	8647	3587	5060	0
svgs/W3C_SVG_11_TestSuite/svg/struct-dom-02-b.svg	pass	5409	2783	2626	0
svgs/W3C_SVG_11_TestSuite/svg/struct-dom-03-b.svg	pass	5426	2806	2620	0
svgs/W3C_SVG_11_TestSuite/svg/struct-dom-04-b.svg	pass	6246	3612	2634	0
svgs/W3C_SVG_11_TestSuite/svg/struct-dom-05-b.svg	pass	6229	3595	2634	0
svgs/W3C_SVG_11_TestSuite/svg/struct-dom-06-b.svg	pass	5048	2193	2855	0
svgs/W3C_SVG_11_TestSuite/svg/struct-dom-07-f.svg	pass	4499	2358	2141	0
svgs/W3C_SVG_11_TestSuite/svg/struct-dom-08-f.svg	pass	3546	1493	2053	0
svgs/W3C_SVG_11_TestSuite/svg/struct-dom-11-f.svg	pass	5653	3404	2249	0
svgs/W3C_SVG_11_TestSuite/svg/struct-dom-12-b.svg	pass	4324	1357	2967	0
svgs/W3C_SVG_11_TestSuite/svg/struct-dom-13-f.svg	pass	5400	3395	2005	0
svgs/W3C_SVG_11_TestSuite/svg/struct-dom-14-f.svg	pass	5211	1301	3910	0
svgs/W3C_SVG_11_TestSuite/svg/struct-dom-15-f.svg	pass	6660	1396	5264	0
svgs/W3C_SVG_11_TestSuite/svg/struct-dom-16-f.svg	pass	5992	3775	2217	0
svgs/W3C_SVG_11_TestSuite/svg/struct-dom-17-f.svg	pass	4712	2630	2082	0
svgs/W3C_SVG_11_TestSuite/svg/struct-dom-18-f.svg	pass	6931	4426	2505	0
svgs/W3C_SVG_11_TestSuite/svg/struct-dom-19-f.svg	pass	4342	2243	2099	0
svgs/W3C_SVG_11_TestSuite/svg/struct-dom-20-f.svg	pass	7282	1516	5766	0
svgs/W3C_SVG_11_TestSuite/svg/struct-frag-01-t.svg	pass	2438	537	1901	0
svgs/W3C_SVG_11_TestSuite/svg/struct-frag-02-t.svg	pass	3554	958	2596	0
svgs/W3C_SVG_11_TestSuite/svg/struct-frag-03-t.svg	pass	3611	931	2680	0
svgs/W3C_SVG_11_TestSuite/svg/struct-frag-04-t.svg	pass	3590	917	2673	1
svgs/W3C_SVG_11_TestSuite/svg/struct-frag-05-t.svg	pass	4942	1429	3513	0
svgs/W3C_SVG_11_TestSuite/svg/struct-frag-06-t.svg	pass	4767	1422	3345	0
svgs/W3C_SVG_11_TestSuite/svg/struct-group-01-t.svg	pass	4231	1087	3144	0
svgs/W3C_SVG_11_TestSuite/svg/struct-group-02-b.svg	pass	4436	1176	3260	0
svgs/W3C_SVG_11_TestSuite/svg/struct-group-03-t.svg	pass	12165	6271	5894	0
svgs/W3C_SVG_11_TestSuite/svg/struct-image-01-t.svg	pass	3289	998	2291	0
svgs/W3C_SVG_11_TestSuite/svg/struct-image-02-b.svg	pass	5000	1881	3119	0
svgs/W3C_SVG_11_TestSuite/svg/struct-image-03-t.svg	pass	3538	1294	2244	0
svgs/W3C_SVG_11_TestSuite/svg/struct-image-04-t.svg	pass	32937	30592	2345	0
svgs/W3C_SVG_11_TestSuite/svg/struct-image-05-b.svg	pass	3096	883	2213	0
svgs/W3C_SVG_11_TestSuite/svg/struct-image-06-t.svg	pass	5562	2005	3557	0
svgs/W3C_SVG_11_TestSuite/svg/struct-image-07-t.svg	pass	3932	1571	2361	0
svgs/W3C_SVG_11_TestSuite/svg/struct-image-08-t.svg	pass	3159	1169	1990	0
svgs/W3C_SVG_11_TestSuite/svg/struct-image-09-t.svg	pass	3161	1184	1977	0
svgs/W3C_SVG_11_TestSuite/svg/struct-image-10-t.svg	pass	3157	1163	1994	0
svgs/W3C_SVG_11_TestSuite/svg/struct-image-11-b.svg	pass	3607	1853	1754	0
svgs/W3C_SVG_11_TestSuite/svg/struct-image-12-b.svg	pass	3837	1506	2331	0
svgs/W3C_SVG_11_TestSuite/svg/struct-image-13-f.svg	pass	5522	2604	2918	0
svgs/W3C_SVG_11_TestSuite/svg/struct-image-14-f.svg	pass	5517	2600	2917	0
svgs/W3C_SVG_11_TestSuite/svg/struct-image-15-f.svg	pass	6635	2841	3794	0
svgs/W3C_SVG_11_TestSuite/svg/struct-image-16-f.svg	pass	2706	904	1802	0
svgs/W3C_SVG_11_TestSuite/svg/struct-image-17-b.svg	pass	3156	1237	1919	0
svgs/W3C_SVG_11_TestSuite/svg/struct-image-18-f.svg	pass	3152	1256	1896	0
svgs/W3C_SVG_11_TestSuite/svg/struct-image-19-f.svg	pass	3368	1340	2028	0
svgs/W3C_SVG_11_TestSuite/svg/struct-svg-01-f.svg	pass	4862	2818	2044	0
svgs/W3C_SVG_11_TestSuite/svg/struct-svg-02-f.svg	pass	6768	5046	1722	0
svgs/W3C_SVG_11_TestSuite/svg/struct-svg-03-f.svg	pass	3111	1324	1787	0
svgs/W3C_SVG_11_TestSuite/svg/struct-symbol-01-b.svg	pass	5049	1308	3741	0
svgs/W3C_SVG_11_TestSuite/svg/struct-use-01-t.svg	pass	5603	2602	3001	0
svgs/W3C_SVG_11_TestSuite/svg/struct-use-03-t.svg	pass	3756	1194	2562	0
svgs/W3C_SVG_11_TestSuite/svg/struct-use-04-b.svg	pass	3406	1175	2231	0
svgs/W3C_SVG_11_TestSuite/svg/struct-use-05-b.svg	pass	4910	1462	3448	0
svgs/W3C_SVG_11_TestSuite/svg/struct-use-06-b.svg	pass	3514	1298	2216	0
svgs/W3C_SVG_11_TestSuite/svg/struct-use-07-b.svg	pass	4399	1903	2496	0
svgs/W3C_SVG_11_TestSuite/svg/struct-use-08-b.svg	pass	3876	1707	2169	0
svgs/W3C_SVG_11_TestSuite/svg/struct-use-09-b.svg	pass	3852	1750	2102	0
svgs/W3C_SVG_11_TestSuite/svg/struct-use-12-f.svg	pass	5877	1765	4112	0
svgs/W3C_SVG_11_TestSuite/svg/struct-use-13-f.svg	pass	3834	1556	2278	0
svgs/W3C_SVG_11_TestSuite/svg/struct-use-14-f.svg	pass	3551	1622	1929	0
svgs/W3C_SVG_11_TestSuite/svg/struct-use-15-f.svg	pass	4024	1824	2200	0
svgs/W3C_SVG_11_TestSuite/svg/styling-class-01-f.svg	pass	3363	1060	2303	0
svgs/W3C_SVG_11_TestSuite/svg/styling-css-02-b.svg	pass	4137	1369	2768	0
svgs/W3C_SVG_11_TestSuite/svg/styling-css-03-b.svg	pass	5246	1553	3693	0
svgs/W3C_SVG_11_TestSuite/svg/styling-css-05-b.svg	pass	3815	1202	2613	0
svgs/W3C_SVG_11_TestSuite/svg/styling-css-06-b.svg	pass	29103	1650	27453	0
svgs/W3C_SVG_11_TestSuite/svg/styling-css-07-f.svg	pass	2899	792	2107	0
svgs/W3C_SVG_11_TestSuite/svg/styling-css-09-f.svg	pass	4404	1737	2667	0
svgs/W3C_SVG_11_TestSuite/svg/styling-css-10-f.svg	pass	3559	1430	2129	0
svgs/W3C_SVG_11_TestSuite/svg/styling-elem-01-b.svg	pass	3519	1241	2278	0
svgs/W3C_SVG_11_TestSuite/svg/styling-inherit-01-b.svg	pass	4258	1294	2964	0
svgs/W3C_SVG_11_TestSuite/svg/styling-pres-01-t.svg	pass	3395	970	2425	0
svgs/W3C_SVG_11_TestSuite/svg/styling-pres-02-f.svg	pass	9352	5016	4336	0
svgs/W3C_SVG_11_TestSuite/svg/styling-pres-03-f.svg	pass	2773	1041	1732	0
svgs/W3C_SVG_11_TestSuite/svg/styling-pres-05-f.svg	pass	3615	1761	1854	0
svgs/W3C_SVG_11_TestSuite/svg/svgdom-over-01-f.svg	pass	8040	6180	1860	0
svgs/W3C_SVG_11_TestSuite/svg/text-align-01-b.svg	pass	4138	1501	2637	0
svgs/W3C_SVG_11_TestSuite/svg/text-align-02-b.svg	pass	3974	1377	2597	0
svgs/W3C_SVG_11_TestSuite/svg/text-align-03-b.svg	pass	3996	1209	2787	0
svgs/W3C_SVG_11_TestSuite/svg/text-align-04-b.svg	pass	4939	1586	3353	0
svgs/W3C_SVG_11_TestSuite/svg/text-align-05-b.svg	pass	3981	1243	2738	0
svgs/W3C_SVG_11_TestSuite/svg/text-align-06-b.svg	pass	4743	1499	3244	0
svgs/W3C_SVG_11_TestSuite/svg/text-align-07-t.svg	pass	4698	1539	3159	0
svgs/W3C_SVG_11_TestSuite/svg/text-align-08-b.svg	pass	4808	1538	3270	0
svgs/W3C_SVG_11_TestSuite/svg/text-altglyph-01-b.svg	pass	6770	1928	4842	0
svgs/W3C_SVG_11_TestSuite/svg/text-altglyph-02-b.svg	pass	17278	11485	5793	0
svgs/W3C_SVG_11_TestSuite/svg/text-altglyph-03-b.svg	pass	18401	12562	5839	0
svgs/W3C_SVG_11_TestSuite/svg/text-bidi-01-t.svg	pass	3174	1196	1978	0
svgs/W3C_SVG_11_TestSuite/svg/text-deco-01-b.svg	pass	4100	1368	2732	0
svgs/W3C_SVG_11_TestSuite/svg/text-dom-01-f.svg	pass	13929	8110	5819	0
svgs/W3C_SVG_11_TestSuite/svg/text-dom-02-f.svg	pass	5572	2735	2837	0
svgs/W3C_SVG_11_TestSuite/svg/text-dom-03-f.svg	pass	5410	2766	2644	0
svgs/W3C_SVG_11_TestSuite/svg/text-dom-04-f.svg	pass	6746	4716	2030	0
svgs/W3C_SVG_11_TestSuite/svg/text-dom-05-f.svg	pass	7071	4339	2732	0
svgs/W3C_SVG_11_TestSuite/svg/text-fonts-01-t.svg	pass	5250	1615	3635	0
svgs/W3C_SVG_11_TestSuite/svg/text-fonts-02-t.svg	pass	4914	1560	3354	0
svgs/W3C_SVG_11_TestSuite/svg/text-fonts-03-t.svg	pass	7279	1438	5841	0
svgs/W3C_SVG_11_TestSuite/svg/text-fonts-04-t.svg	pass	4212	1432	2780	0
svgs/W3C_SVG_11_TestSuite/svg/text-fonts-05-f.svg	pass	2980	1126	1854	0
svgs/W3C_SVG_11_TestSuite/svg/text-fonts-202-t.svg	pass	5151	1670	3481	0
svgs/W3C_SVG_11_TestSuite/svg/text-fonts-203-t.svg	pass	6498	1684	4814	0
svgs/W3C_SVG_11_TestSuite/svg/text-fonts-204-t.svg	pass	6129	2832	3297	0
svgs/W3C_SVG_11_TestSuite/svg/text-intro-01-t.svg	pass	5081	1577	3504	0
svgs/W3C_SVG_11_TestSuite/svg/text-intro-02-b.svg	pass	4605	1736	2869	0
svgs/W3C_SVG_11_TestSuite/svg/text-intro-03-b.svg	pass	4721	1257	3464	0
svgs/W3C_SVG_11_TestSuite/svg/text-intro-04-t.svg	pass	4247	1516	2731	0
svgs/W3C_SVG_11_TestSuite/svg/text-intro-05-t.svg	pass	4109	1143	2966	0
svgs/W3C_SVG_11_TestSuite/svg/text-intro-06-t.svg	pass	4750	1301	3449	0
svgs/W3C_SVG_11_TestSuite/svg/text-intro-07-t.svg	pass	3219	991	2228	0
svgs/W3C_SVG_11_TestSuite/svg/text-intro-09-b.svg	pass	4677	1932	2745	0
svgs/W3C_SVG_11_TestSuite/svg/text-intro-10-f.svg	pass	4219	1364	2855	0
svgs/W3C_SVG_11_TestSuite/svg/text-intro-11-t.svg	pass	4700	1471	3229	0
svgs/W3C_SVG_11_TestSuite/svg/text-intro-12-t.svg	pass	4444	1566	2878	0
svgs/W3C_SVG_11_TestSuite/svg/text-path-01-b.svg	pass	4935	2328	2607	0
svgs/W3C_SVG_11_TestSuite/svg/text-path-02-b.svg	pass	4941	2255	2686	0
svgs/W3C_SVG_11_TestSuite/svg/text-spacing-01-b.svg	pass	3784	1086	2698	0
svgs/W3C_SVG_11_TestSuite/svg/text-text-01-b.svg	pass	10257	3275	6982	0
svgs/W3C_SVG_11_TestSuite/svg/text-text-03-b.svg	pass	5248	1617	3631	0
svgs/W3C_SVG_11_TestSuite/svg/text-text-04-t.svg	pass	11509	6530	4979	0
svgs/W3C_SVG_11_TestSuite/svg/text-text-05-t.svg	pass	8364	4669	3695	0
svgs/W3C_SVG_11_TestSuite/svg/text-text-06-t.svg	pass	7434	3180	4254	0
svgs/W3C_SVG_11_TestSuite/svg/text-text-07-t.svg	pass	4255	1105	3150	0
svgs/W3C_SVG_11_TestSuite/svg/text-text-08-b.svg	pass	3766	983	2783	0
svgs/W3C_SVG_11_TestSuite/svg/text-text-09-t.svg	pass	4579	1017	3562	0
svgs/W3C_SVG_11_TestSuite/svg/text-text-10-t.svg	pass	4553	2442	2111	0
svgs/W3C_SVG_11_TestSuite/svg/text-text-11-t.svg	pass	4903	2425	2478	0
svgs/W3C_SVG_11_TestSuite/svg/text-text-12-t.svg	pass	8863	5159	3704	0
svgs/W3C_SVG_11_TestSuite/svg/text-tref-01-b.svg	pass	3737	1218	2519	0
svgs/W3C_SVG_11_TestSuite/svg/text-tref-02-b.svg	pass	3698	1089	2609	0
svgs/W3C_SVG_11_TestSuite/svg/text-tref-03-b.svg	pass	3749	1288	2461	0
svgs/W3C_SVG_11_TestSuite/svg/text-tselect-01-b.svg	pass	4184	1539	2645	0
svgs/W3C_SVG_11_TestSuite/svg/text-tselect-02-f.svg	pass	6469	1873	4596	0
svgs/W3C_SVG_11_TestSuite/svg/text-tselect-03-f.svg	pass	6855	2036	4819	0
svgs/W3C_SVG_11_TestSuite/svg/text-tspan-01-b.svg	pass	6447	2397	4050	0
svgs/W3C_SVG_11_TestSuite/svg/text-tspan-02-b.svg	pass	6546	2319	4227	0
svgs/W3C_SVG_11_TestSuite/svg/text-ws-01-t.svg	pass	5664	1685	3979	0
svgs/W3C_SVG_11_TestSuite/svg/text-ws-02-t.svg	pass	5769	1757	4012	0
svgs/W3C_SVG_11_TestSuite/svg/text-ws-03-t.svg	pass	4026	1744	2282	0
svgs/W3C_SVG_11_TestSuite/svg/types-basic-01-f.svg	pass	3521	1237	2284	0
svgs/W3C_SVG_11_TestSuite/svg/types-basic-02-f.svg	pass	4451	1882	2569	0
svgs/W3C_SVG_11_TestSuite/svg/types-dom-01-b.svg	pass	6560	3644	2916	0
svgs/W3C_SVG_11_TestSuite/svg/types-dom-02-f.svg	pass	6180	3335	2845	0
svgs/W3C_SVG_11_TestSuite/svg/types-dom-03-b.svg	pass	3502	1476	2026	0
svgs/W3C_SVG_11_TestSuite/svg/types-dom-04-b.svg	pass	9585	6319	3266	0
svgs/W3C_SVG_11_TestSuite/svg/types-dom-05-b.svg	pass	5146	2936	2210	0
svgs/W3C_SVG_11_TestSuite/svg/types-dom-06-f.svg	pass	5190	1512	3678	0
svgs/W3C_SVG_11_TestSuite/svg/types-dom-07-f.svg	pass	6288	3529	2759	0
svgs/W3C_SVG_11_TestSuite/svg/types-dom-08-f.svg	pass	8417	6463	1954	0
svgs/W3C_SVG_11_TestSuite/svg/types-dom-svgfittoviewbox-01-f.svg	pass	4126	2373	1753	0
svgs/W3C_SVG_11_TestSuite/svg/types-dom-svglengthlist-01-f.svg	pass	4788	2784	2004	0
svgs/W3C_SVG_11_TestSuite/svg/types-dom-svgnumberlist-01-f.svg	pass	4799	2790	2009	0
svgs/W3C_SVG_11_TestSuite/svg/types-dom-svgstringlist-01-f.svg	pass	4628	2657	1971	0
svgs/W3C_SVG_11_TestSuite/svg/types-dom-svgtransformable-01-f.svg	pass	3830	2314	1516	0
svgs/oxygen-icons-5.113.0/scalable/actions/application-exit.svg	pass	36889	14236	22653	0
svgs/oxygen-icons-5.113.0/scalable/actions/appointment-new.svg	pass	89047	37200	51847	0
svgs/oxygen-icons-5.113.0/scalable/actions/arrow-down-double.svg	pass	38955	10171	28784	0
svgs/oxygen-icons-5.113.0/scalable/actions/arrow-down.svg	pass	35427	8171	27256	0
svgs/oxygen-icons-5.113.0/scalable/actions/arrow-left-double.svg	pass	38742	10007	28735	0
svgs/oxygen-icons-5.113.0/scalable/actions/arrow-left.svg	pass	35373	8031	27342	0
svgs/oxygen-icons-5.113.0/scalable/actions/arrow-right-double.svg	pass	42806	10133	32673	0
svgs/oxygen-icons-5.113.0/scalable/actions/arrow-right.svg	pass	35374	8102	27272	0
svgs/oxygen-icons-5.113.0/scalable/actions/arrow-up-double.svg	pass	38950	10223	28727	0
svgs/oxygen-icons-5.113.0/scalable/actions/arrow-up.svg	pass	35419	8179	27240	0
svgs/oxygen-icons-5.113.0/scalable/actions/bookmark-new-list.svg	pass	126573	52576	73997	0
svgs/oxygen-icons-5.113.0/scalable/actions/bookmark-new.svg	pass	29036	9576	19460	0
svgs/oxygen-icons-5.113.0/scalable/actions/bookmark-toolbar.svg	pass	93905	23138	70767	0
svgs/oxygen-icons-5.113.0/scalable/actions/call-start.svg	pass	43839	7956	35883	0
svgs/oxygen-icons-5.113.0/scalable/actions/call-stop.svg	pass	60538	7741	52797	0
svgs/oxygen-icons-5.113.0/scalable/actions/character-set.svg	pass	7814	3287	4527	0
svgs/oxygen-icons-5.113.0/scalable/actions/chronometer.svg	pass	152377	96040	56337	2
svgs/oxygen-icons-5.113.0/scalable/actions/configure-shortcuts.svg	pass	172156	27536	144620	0
svgs/oxygen-icons-5.113.0/scalable/actions/configure-toolbars.svg	pass	104914	36152	68762	0
svgs/oxygen-icons-5.113.0/scalable/actions/configure.svg	pass	177750	30156	147594	0
svgs/oxygen-icons-5.113.0/scalable/actions/contact-new.svg	pass	247470	116542	130928	0
svgs/oxygen-icons-5.113.0/scalable/actions/dashboard-show.svg	pass	251893	128413	123480	0
svgs/oxygen-icons-5.113.0/scalable/actions/dialog-cancel.svg	pass	32985	13156	19829	0
svgs/oxygen-icons-5.113.0/scalable/actions/dialog-close.svg	pass	12793	4372	8421	0
svgs/oxygen-icons-5.113.0/scalable/actions/dialog-ok-apply.svg	pass	19900	9069	10831	0
svgs/oxygen-icons-5.113.0/scalable/actions/dialog-ok.svg	pass	20670	9258	11412	0
svgs/oxygen-icons-5.113.0/scalable/actions/document-close.svg	pass	13577	8674	4903	0
svgs/oxygen-icons-5.113.0/scalable/actions/document-decrypt.svg	pass	276159	181234	94925	0
svgs/oxygen-icons-5.113.0/scalable/actions/document-edit.svg	pass	559805	17277	542528	0
svgs/oxygen-icons-5.113.0/scalable/actions/document-encrypt.svg	pass	275209	181213	93996	0
svgs/oxygen-icons-5.113.0/scalable/actions/document-new.svg	pass	18127	8106	10021	0
svgs/oxygen-icons-5.113.0/scalable/actions/document-open-recent.svg	pass	22278	9661	12617	2
svgs/oxygen-icons-5.113.0/scalable/actions/document-preview-archive.svg	pass	182972	34391	148581	0
svgs/oxygen-icons-5.113.0/scalable/actions/document-preview.svg	pass	135881	29699	106182	0
svgs/oxygen-icons-5.113.0/scalable/actions/document-print-direct.svg	pass	73592	31270	42322	0
svgs/oxygen-icons-5.113.0/scalable/actions/document-print-frame.svg	pass	364728	23418	341310	0
svgs/oxygen-icons-5.113.0/scalable/actions/document-print-preview.svg	mismatch	413415	35890	377525	6
svgs/oxygen-icons-5.113.0/scalable/actions/document-print.svg	pass	358767	21793	336974	0
svgs/oxygen-icons-5.113.0/scalable/actions/document-properties.svg	pass	44223	18399	25824	0
svgs/oxygen-icons-5.113.0/scalable/actions/document-revert.svg	pass	45762	21596	24166	0
svgs/oxygen-icons-5.113.0/scalable/actions/document-save-all.svg	pass	2364155	1487412	876743	0
svgs/oxygen-icons-5.113.0/scalable/actions/document-save-as.svg	pass	1189733	760438	429295	0
svgs/oxygen-icons-5.113.0/scalable/actions/document-save.svg	pass	1116723	747421	369302	0
svgs/oxygen-icons-5.113.0/scalable/actions/document-sign.svg	pass	70281	21669	48612	0
svgs/oxygen-icons-5.113.0/scalable/actions/draw-brush.svg	pass	27358	13413	13945	0
svgs/oxygen-icons-5.113.0/scalable/actions/draw-eraser.svg	pass	88020	14240	73780	0
svgs/oxygen-icons-5.113.0/scalable/actions/draw-freehand.svg	pass	56327	13932	42395	0
svgs/oxygen-icons-5.113.0/scalable/actions/draw-text.svg	pass	10064	1395	8669	0
svgs/oxygen-icons-5.113.0/scalable/actions/edit-bomb.svg	mismatch	134577	18554	116023	7
svgs/oxygen-icons-5.113.0/scalable/actions/edit-clear-history.svg	pass	53368	22662	30706	0
svgs/oxygen-icons-5.113.0/scalable/actions/edit-clear-locationbar-ltr.svg	pass	27797	9500	18297	0
svgs/oxygen-icons-5.113.0/scalable/actions/edit-clear-locationbar-rtl.svg	pass	27070	9221	17849	0
svgs/oxygen-icons-5.113.0/scalable/actions/edit-clear.svg	pass	252756	39241	213515	0
svgs/oxygen-icons-5.113.0/scalable/actions/edit-copy.svg	pass	14791	3422	11369	0
svgs/oxygen-icons-5.113.0/scalable/actions/edit-cut.svg	pass	44432	17582	26850	0
svgs/oxygen-icons-5.113.0/scalable/actions/edit-delete-shred.svg	pass	367707	20663	347044	0
svgs/oxygen-icons-5.113.0/scalable/actions/edit-delete.svg	pass	183151	12905	170246	0
svgs/oxygen-icons-5.113.0/scalable/actions/edit-find-mail.svg	pass	118019	65502	52517	0
svgs/oxygen-icons-5.113.0/scalable/actions/edit-find-user.svg	pass	364049	92202	271847	1
svgs/oxygen-icons-5.113.0/scalable/actions/edit-find.svg	pass	151850	64551	87299	1
svgs/oxygen-icons-5.113.0/scalable/actions/edit-paste.svg	pass	113986	16101	97885	0
svgs/oxygen-icons-5.113.0/scalable/actions/edit-redo.svg	pass	37276	18317	18959	0
svgs/oxygen-icons-5.113.0/scalable/actions/edit-rename.svg	pass	35606	2723	32883	0
svgs/oxygen-icons-5.113.0/scalable/actions/edit-undo.svg	pass	35899	17307	18592	0
svgs/oxygen-icons-5.113.0/scalable/actions/feed-subscribe.svg	pass	27936	15309	12627	0
svgs/oxygen-icons-5.113.0/scalable/actions/fill-color.svg	pass	54175	23561	30614	0
svgs/oxygen-icons-5.113.0/scalable/actions/flag-black.svg	pass	29081	15897	13184	0
svgs/oxygen-icons-5.113.0/scalable/actions/flag-blue.svg	pass	32790	16964	15826	0
svgs/oxygen-icons-5.113.0/scalable/actions/flag-green.svg	pass	31882	16532	15350	0
svgs/oxygen-icons-5.113.0/scalable/actions/flag-red.svg	pass	31597	16965	14632	0
svgs/oxygen-icons-5.113.0/scalable/actions/flag-yellow.svg	pass	31600	16965	14635	0
svgs/oxygen-icons-5.113.0/scalable/actions/flag.svg	pass	31882	16532	15350	0
svgs/oxygen-icons-5.113.0/scalable/actions/fork.svg	pass	35047	18399	16648	0
svgs/oxygen-icons-5.113.0/scalable/actions/format-fill-color.svg	pass	54175	23561	30614	0
svgs/oxygen-icons-5.113.0/scalable/actions/format-stroke-color.svg	pass	103713	20285	83428	0
svgs/oxygen-icons-5.113.0/scalable/actions/format-text-color.svg	pass	91476	3963	87513	0
svgs/oxygen-icons-5.113.0/scalable/actions/games-config-background.svg	pass	1058528	551579	506949	0
svgs/oxygen-icons-5.113.0/scalable/actions/games-config-board.svg	pass	35109	15254	19855	0
svgs/oxygen-icons-5.113.0/scalable/actions/games-config-custom.svg	pass	310571	92945	217626	0
svgs/oxygen-icons-5.113.0/scalable/actions/games-config-options.svg	pass	257720	74459	183261	0
svgs/oxygen-icons-5.113.0/scalable/actions/games-config-theme.svg	pass	377538	72924	304614	0
svgs/oxygen-icons-5.113.0/scalable/actions/games-config-tiles.svg	pass	19584	9347	10237	0
svgs/oxygen-icons-5.113.0/scalable/actions/games-difficult.svg	pass	196571	3808	192763	0
svgs/oxygen-icons-5.113.0/scalable/actions/games-endturn.svg	pass	192120	1398	190722	0
svgs/oxygen-icons-5.113.0/scalable/actions/games-hint.svg	pass	386677	29846	356831	0
svgs/oxygen-icons-5.113.0/scalable/actions/games-solve.svg	pass	102636	54638	47998	0
svgs/oxygen-icons-5.113.0/scalable/actions/get-hot-new-stuff.svg	pass	31246	13228	18018	0
svgs/oxygen-icons-5.113.0/scalable/actions/go-bottom.svg	pass	88049	16333	71716	0
svgs/oxygen-icons-5.113.0/scalable/actions/go-down-search.svg	pass	63388	7645	55743	0
svgs/oxygen-icons-5.113.0/scalable/actions/go-down.svg	pass	44323	11172	33151	0
svgs/oxygen-icons-5.113.0/scalable/actions/go-first-view-page.svg	pass	97481	23646	73835	0
svgs/oxygen-icons-5.113.0/scalable/actions/go-first-view.svg	pass	42182	11472	30710	0
svgs/oxygen-icons-5.113.0/scalable/actions/go-first.svg	pass	108477	14655	93822	0
svgs/oxygen-icons-5.113.0/scalable/actions/go-home.svg	pass	34902	14768	20134	0
svgs/oxygen-icons-5.113.0/scalable/actions/go-jump-today.svg	pass	91819	35516	56303	0
svgs/oxygen-icons-5.113.0/scalable/actions/go-jump.svg	pass	5969	2539	3430	1
svgs/oxygen-icons-5.113.0/scalable/actions/go-last-view-page.svg	pass	97374	23607	73767	0
svgs/oxygen-icons-5.113.0/scalable/actions/go-last-view.svg	pass	37858	11785	26073	1
svgs/oxygen-icons-5.113.0/scalable/actions/go-last.svg	pass	129883	16038	113845	0
svgs/oxygen-icons-5.113.0/scalable/actions/go-next-view-page.svg	pass	84367	17158	67209	0
svgs/oxygen-icons-5.113.0/scalable/actions/go-next-view.svg	pass	11202	5962	5240	1
svgs/oxygen-icons-5.113.0/scalable/actions/go-next.svg	pass	33638	10383	23255	0
svgs/oxygen-icons-5.113.0/scalable/actions/go-previous-view-page.svg	pass	84215	17137	67078	0
svgs/oxygen-icons-5.113.0/scalable/actions/go-previous-view.svg	pass	10350	5418	4932	0
svgs/oxygen-icons-5.113.0/scalable/actions/go-previous.svg	pass	36316	9264	27052	0
svgs/oxygen-icons-5.113.0/scalable/actions/go-top.svg	pass	116030	15687	100343	0
svgs/oxygen-icons-5.113.0/scalable/actions/go-up-search.svg	pass	58217	7687	50530	0
svgs/oxygen-icons-5.113.0/scalable/actions/go-up.svg	pass	38711	10393	28318	0
svgs/oxygen-icons-5.113.0/scalable/actions/help-contextual.svg	pass	463658	101644	362014	0
svgs/oxygen-icons-5.113.0/scalable/actions/help-hint.svg	pass	51296	28691	22605	0
svgs/oxygen-icons-5.113.0/scalable/actions/hidef/archive-insert-directory.svg	pass	173769	127053	46716	0
svgs/oxygen-icons-5.113.0/scalable/actions/hidef/continue-data-project.svg	mismatch	83679	44196	39483	410
svgs/oxygen-icons-5.113.0/scalable/actions/hidef/folder-new.svg	pass	173769	127053	46716	0
svgs/oxygen-icons-5.113.0/scalable/actions/hidef/tools-media-optical-copy.svg	pass	54938	29222	25716	0
svgs/oxygen-icons-5.113.0/scalable/actions/hidef/tools-media-optical-erase.svg	pass	125854	25120	100734	0
svgs/oxygen-icons-5.113.0/scalable/actions/hidef/tools-media-optical-format.svg	pass	60907	32884	28023	0
svgs/oxygen-icons-5.113.0/scalable/actions/hidef/tools-rip-audio-cd.svg	pass	168814	50838	117976	0
svgs/oxygen-icons-5.113.0/scalable/actions/hidef/tools-rip-video-cd.svg	pass	484245	285752	198493	0
svgs/oxygen-icons-5.113.0/scalable/actions/hidef/tools-rip-video-dvd.svg	pass	1702938	506932	1196006	0
svgs/oxygen-icons-5.113.0/scalable/actions/im-ban-kick-user.svg	mismatch	105229	49482	55747	24
svgs/oxygen-icons-5.113.0/scalable/actions/im-ban-user.svg	mismatch	60900	26395	34505	10
svgs/oxygen-icons-5.113.0/scalable/actions/im-invisible-user.svg	pass	172968	27243	145725	0
svgs/oxygen-icons-5.113.0/scalable/actions/im-kick-user.svg	pass	52997	24148	28849	0
svgs/oxygen-icons-5.113.0/scalable/actions/im-user-away.svg	pass	158079	24275	133804	0
svgs/oxygen-icons-5.113.0/scalable/actions/im-user-busy.svg	pass	65295	35059	30236	0
svgs/oxygen-icons-5.113.0/scalable/actions/im-user-offline.svg	pass	44503	22748	21755	0
svgs/oxygen-icons-5.113.0/scalable/actions/im-user.svg	pass	143209	14122	129087	0
svgs/oxygen-icons-5.113.0/scalable/actions/insert-horizontal-rule.svg	pass	219790	13828	205962	0
svgs/oxygen-icons-5.113.0/scalable/actions/insert-image.svg	pass	930007	562458	367549	0
svgs/oxygen-icons-5.113.0/scalable/actions/insert-link.svg	pass	195009	16747	178262	0
svgs/oxygen-icons-5.113.0/scalable/actions/insert-table.svg	pass	41601	16327	25274	0
svgs/oxygen-icons-5.113.0/scalable/actions/insert-text.svg	pass	38379	14129	24250	0
svgs/oxygen-icons-5.113.0/scalable/actions/irc-close-channel.svg	mismatch	66512	33999	32513	7
svgs/oxygen-icons-5.113.0/scalable/actions/irc-join-channel.svg	pass	273405	36090	237315	0
svgs/oxygen-icons-5.113.0/scalable/actions/irc-operator.svg	pass	92010	44869	47141	1
svgs/oxygen-icons-5.113.0/scalable/actions/irc-remove-operator.svg	mismatch	151239	57026	94213	38
svgs/oxygen-icons-5.113.0/scalable/actions/irc-unvoice.svg	mismatch	60869	28794	32075	9
svgs/oxygen-icons-5.113.0/scalable/actions/irc-voice.svg	pass	31855	16193	15662	0
svgs/oxygen-icons-5.113.0/scalable/actions/key-enter.svg	pass	141876	8399	133477	2
svgs/oxygen-icons-5.113.0/scalable/actions/layer-visible-off.svg	pass	32870	14153	18717	0
svgs/oxygen-icons-5.113.0/scalable/actions/layer-visible-on.svg	pass	55282	14124	41158	1
svgs/oxygen-icons-5.113.0/scalable/actions/list-add-font.svg	pass	240280	15445	224835	0
svgs/oxygen-icons-5.113.0/scalable/actions/list-add-user.svg	pass	149830	37820	112010	0
svgs/oxygen-icons-5.113.0/scalable/actions/list-add.svg	mismatch	21650	10836	10814	136
svgs/oxygen-icons-5.113.0/scalable/actions/list-remove-user.svg	mismatch	194208	37553	156655	6
svgs/oxygen-icons-5.113.0/scalable/actions/list-remove.svg	mismatch	14594	6637	7957	362
svgs/oxygen-icons-5.113.0/scalable/actions/mail-flag.svg	pass	67716	37931	29785	0
svgs/oxygen-icons-5.113.0/scalable/actions/mail-mark-junk.svg	pass	110844	31865	78979	0
svgs/oxygen-icons-5.113.0/scalable/actions/mail-mark-task.svg	pass	62361	35611	26750	2
svgs/oxygen-icons-5.113.0/scalable/actions/mail-receive.svg	pass	57033	13888	43145	0
svgs/oxygen-icons-5.113.0/scalable/actions/mail-send.svg	mismatch	29737	13637	16100	5
svgs/oxygen-icons-5.113.0/scalable/actions/media-eject.svg	pass	8207	3054	5153	0
svgs/oxygen-icons-5.113.0/scalable/actions/media-playback-pause.svg	pass	8309	3065	5244	0
svgs/oxygen-icons-5.113.0/scalable/actions/media-playback-start.svg	pass	7618	2757	4861	0
svgs/oxygen-icons-5.113.0/scalable/actions/media-playback-stop.svg	pass	7730	2779	4951	0
svgs/oxygen-icons-5.113.0/scalable/actions/media-record.svg	pass	7773	2876	4897	0
svgs/oxygen-icons-5.113.0/scalable/actions/media-seek-backward.svg	pass	8809	3045	5764	0
svgs/oxygen-icons-5.113.0/scalable/actions/media-seek-forward.svg	pass	8125	3042	5083	0
svgs/oxygen-icons-5.113.0/scalable/actions/media-skip-backward.svg	pass	8208	3050	5158	0
svgs/oxygen-icons-5.113.0/scalable/actions/media-skip-forward.svg	pass	8202	3044	5158	0
svgs/oxygen-icons-5.113.0/scalable/actions/network-connect.svg	pass	61992	20887	41105	0
svgs/oxygen-icons-5.113.0/scalable/actions/network-disconnect.svg	pass	44558	16539	28019	0
svgs/oxygen-icons-5.113.0/scalable/actions/object-flip-horizontal.svg	pass	73516	6294	67222	0
svgs/oxygen-icons-5.113.0/scalable/actions/object-flip-vertical.svg	pass	73491	5952	67539	0
svgs/oxygen-icons-5.113.0/scalable/actions/office-chart-area-focus-peak-node.svg	pass	15748	7249	8499	0
svgs/oxygen-icons-5.113.0/scalable/actions/office-chart-area-percentage.svg	pass	22543	8194	14349	0
svgs/oxygen-icons-5.113.0/scalable/actions/office-chart-area-stacked.svg	pass	11935	6011	5924	0
svgs/oxygen-icons-5.113.0/scalable/actions/office-chart-area.svg	pass	13312	5969	7343	0
svgs/oxygen-icons-5.113.0/scalable/actions/office-chart-bar-percentage.svg	pass	152820	12706	140114	0
svgs/oxygen-icons-5.113.0/scalable/actions/office-chart-bar-stacked.svg	pass	144944	11913	133031	0
svgs/oxygen-icons-5.113.0/scalable/actions/office-chart-bar.svg	pass	139563	7361	132202	0
svgs/oxygen-icons-5.113.0/scalable/actions/office-chart-line-percentage.svg	pass	16128	5109	11019	0
svgs/oxygen-icons-5.113.0/scalable/actions/office-chart-line-stacked.svg	pass	8074	3808	4266	0
svgs/oxygen-icons-5.113.0/scalable/actions/office-chart-line.svg	pass	7762	3785	3977	0
svgs/oxygen-icons-5.113.0/scalable/actions/office-chart-pie.svg	pass	134677	16835	117842	0
svgs/oxygen-icons-5.113.0/scalable/actions/office-chart-polar-stacked.svg	pass	12113	4300	7813	0
svgs/oxygen-icons-5.113.0/scalable/actions/office-chart-polar.svg	pass	69730	2547	67183	0
svgs/oxygen-icons-5.113.0/scalable/actions/office-chart-ring.svg	pass	34227	9855	24372	0
svgs/oxygen-icons-5.113.0/scalable/actions/office-chart-scatter.svg	pass	73219	5052	68167	0
svgs/oxygen-icons-5.113.0/scalable/actions/player-time.svg	pass	156674	97808	58866	0
svgs/oxygen-icons-5.113.0/scalable/actions/player-volume.svg	mismatch	24632	10233	14399	10
svgs/oxygen-icons-5.113.0/scalable/actions/process-stop.svg	pass	18090	9156	8934	0
svgs/oxygen-icons-5.113.0/scalable/actions/quickopen-file.svg	pass	47735	14945	32790	0
svgs/oxygen-icons-5.113.0/scalable/actions/quickopen.svg	pass	40310	11165	29145	0
svgs/oxygen-icons-5.113.0/scalable/actions/rating.svg	pass	36369	16461	19908	0
svgs/oxygen-icons-5.113.0/scalable/actions/resource-group.svg	pass	186562	146960	39602	0
svgs/oxygen-icons-5.113.0/scalable/actions/roll.svg	pass	38552	15590	22962	0
svgs/oxygen-icons-5.113.0/scalable/actions/select-rectangular.svg	pass	36096	18431	17665	0
svgs/oxygen-icons-5.113.0/scalable/actions/services.svg	pass	32790	16964	15826	0
svgs/oxygen-icons-5.113.0/scalable/actions/show-menu.svg	pass	193812	1664	192148	0
svgs/oxygen-icons-5.113.0/scalable/actions/skg-chart-bubble.svg	pass	72227	3312	68915	0
svgs/oxygen-icons-5.113.0/scalable/actions/skrooge_credit_card.svg	pass	769475	447078	322397	0
svgs/oxygen-icons-5.113.0/scalable/actions/skrooge_less.svg	pass	7092	2670	4422	0
svgs/oxygen-icons-5.113.0/scalable/actions/skrooge_more.svg	pass	7080	2661	4419	0
svgs/oxygen-icons-5.113.0/scalable/actions/skrooge_much_less.svg	pass	7550	2673	4877	0
svgs/oxygen-icons-5.113.0/scalable/actions/skrooge_much_more.svg	pass	7298	2670	4628	0
svgs/oxygen-icons-5.113.0/scalable/actions/skrooge_type.svg	pass	31984	15479	16505	1
svgs/oxygen-icons-5.113.0/scalable/actions/small/16x16/acrobat.svg	pass	10962	3850	7112	0
svgs/oxygen-icons-5.113.0/scalable/actions/small/16x16/address-book-new.svg	pass	3008143	2327510	680633	0
svgs/oxygen-icons-5.113.0/scalable/actions/small/16x16/align-horizontal-center.svg	pass	10486	5097	5389	0
svgs/oxygen-icons-5.113.0/scalable/actions/small/16x16/align-horizontal-left-out.svg	pass	11707	5509	6198	0
svgs/oxygen-icons-5.113.0/scalable/actions/small/16x16/align-horizontal-left.svg	pass	9041	4005	5036	0
svgs/oxygen-icons-5.113.0/scalable/actions/small/16x16/align-horizontal-right-out.svg	pass	11752	5546	6206	0
svgs/oxygen-icons-5.113.0/scalable/actions/small/16x16/align-horizontal-right.svg	pass	9076	4039	5037	0
svgs/oxygen-icons-5.113.0/scalable/actions/small/16x16/align-vertical-bottom-out.svg	pass	11851	5643	6208	0
svgs/oxygen-icons-5.113.0/scalable/actions/small/16x16/align-vertical-bottom.svg	pass	9466	4348	5118	0
svgs/oxygen-icons-5.113.0/scalable/actions/small/16x16/align-vertical-center.svg	pass	10879	5441	5438	0
svgs/oxygen-icons-5.113.0/scalable/actions/small/16x16/align-vertical-top-out.svg	pass	38476	5640	32836	0
svgs/oxygen-icons-5.113.0/scalable/actions/small/16x16/align-vertical-top.svg	pass	35167	4347	30820	0
svgs/oxygen-icons-5.113.0/scalable/actions/small/16x16/application-exit.svg	pass	38044	14834	23210	1
svgs/oxygen-icons-5.113.0/scalable/actions/small/16x16/appointment-new.svg	pass	86846	36495	50351	0
svgs/oxygen-icons-5.113.0/scalable/actions/small/16x16/archive-extract.svg	pass	23071	8685	14386	0
svgs/oxygen-icons-5.113.0/scalable/actions/small/16x16/archive-insert-directory.svg	pass	1195796	126773	1069023	0
svgs/oxygen-icons-5.113.0/scalable/actions/small/16x16/archive-insert.svg	pass	31069	15633	15436	0
svgs/oxygen-icons-5.113.0/scalable/actions/small/16x16/archive-remove.svg	pass	19825	7910	11915	0
svgs/oxygen-icons-5.113.0/scalable/actions/small/16x16/arrow-down-double.svg	pass	39869	14783	25086	0
svgs/oxygen-icons-5.113.0/scalable/actions/small/16x16/arrow-down.svg	pass	33174	9611	23563	0
svgs/oxygen-icons-5.113.0/scalable/actions/small/16x16/arrow-left-double.svg	pass	33964	14203	19761	0
svgs/oxygen-icons-5.113.0/scalable/actions/small/16x16/arrow-left.svg	pass	32965	9326	23639	0
svgs/oxygen-icons-5.113.0/scalable/actions/small/16x16/arrow-right-double.svg	pass	39866	14802	25064	0
svgs/oxygen-icons-5.113.0/scalable/actions/small/16x16/arrow-right.svg	pass	37192	9646	27546	0
svgs/oxygen-icons-5.113.0/scalable/actions/small/16x16/arrow-up-double.svg	pass	39867	14813	25054	0
svgs/oxygen-icons-5.113.0/scalable/actions/small/16x16/arrow-up.svg	pass	33174	9611	23563	0
svgs/oxygen-icons-5.113.0/scalable/actions/small/16x16/bookmark-new-list.svg	pass	39283	18984	20299	0
svgs/oxygen-icons-5.113.0/scalable/actions/small/16x16/bookmark-new.svg	pass	36124	10337	25787	0
svgs/oxygen-icons-5.113.0/scalable/actions/small/16x16/bookmark-toolbar.svg	pass	213835	19698	194137	0
svgs/oxygen-icons-5.113.0/scalable/actions/small/16x16/bookmarks-organize.svg	pass	423836	397990	25846	0
svgs/oxygen-icons-5.113.0/scalable/actions/small/16x16/call-start.svg	pass	43838	7964	35874	0
svgs/oxygen-icons-5.113.0/scalable/actions/small/16x16/call-stop.svg	pass	60543	7738	52805	0
svgs/oxygen-icons-5.113.0/scalable/actions/small/16x16/character-set.svg	pass	7108	2206	4902	0
svgs/oxygen-icons-5.113.0/scalable/actions/small/16x16/checkbox.svg	pass	21764	5407	16357	0
svgs/oxygen-icons-5.113.0/scalable/actions/small/16x16/code-block.svg	pass	41591	8911	32680	0
svgs/oxygen-icons-5.113.0/scalable/actions/small/16x16/code-class.svg	pass	42815	10666	32149	0
svgs/oxygen-icons-5.113.0/scalable/actions/small/16x16/code-context.svg	pass	144895	5814	139081	0
svgs/oxygen-icons-5.113.0/scalable/actions/small/16x16/code-function.svg	pass	35954	6107	29847	0
svgs/oxygen-icons-5.113.0/scalable/actions/small/16x16/code-typedef.svg	pass	39568	4233	35335	0
svgs/oxygen-icons-5.113.0/scalable/actions/small/16x16/code-variable.svg	pass	10442	4185	6257	0
svgs/oxygen-icons-5.113.0/scalable/actions/small/16x16/color-picker-black.svg	pass	76039	20379	55660	0
svgs/oxygen-icons-5.113.0/scalable/actions/small/16x16/color-picker-grey.svg	pass	38414	19894	18520	0
svgs/oxygen-icons-5.113.0/scalable/actions/small/16x16/color-picker-white.svg	pass	38407	19886	18521	0
svgs/oxygen-icons-5.113.0/scalable/actions/small/16x16/color-picker.svg	pass	45990	16743	29247	0
svgs/oxygen-icons-5.113.0/scalable/actions/small/16x16/configure-shortcuts.svg	pass	186133	30862	155271	0
svgs/oxygen-icons-5.113.0/scalable/actions/small/16x16/configure-toolbars.svg	pass	224512	30377	194135	0
svgs/oxygen-icons-5.113.0/scalable/actions/small/16x16/configure.svg	pass	174393	25845	148548	0
svgs/oxygen-icons-5.113.0/scalable/actions/small/16x16/contact-new.svg	pass	95277	41349	53928	1
svgs/oxygen-icons-5.113.0/scalable/actions/small/16x16/debug-execute-from-cursor.svg	pass	36960	2938	34022	0
svgs/oxygen-icons-5.113.0/scalable/actions/small/16x16/debug-execute-to-cursor.svg	pass	35706	2923	32783	0
svgs/oxygen-icons-5.113.0/scalable/actions/small/16x16/debug-run-cursor.svg	pass	266093	41614	224479	0
svgs/oxygen-icons-5.113.0/scalable/actions/small/16x16/debug-run.svg	pass	262765	40047	222718	0
svgs/oxygen-icons-5.113.0/scalable/actions/small/16x16/debug-step-instruction.svg	pass	38765	6718	32047	0
svgs/oxygen-icons-5.113.0/scalable/actions/small/16x16/debug-step-into-instruction.svg	pass	40278	7182	33096	0
svgs/oxygen-icons-5.113.0/scalable/actions/small/16x16/debug-step-into.svg	pass	39984	7134	32850	0
svgs/oxygen-icons-5.113.0/scalable/actions/small/16x16/debug-step-out.svg	pass	37987	6395	31592	0
svgs/oxygen-icons-5.113.0/scalable/actions/small/16x16/debug-step-over.svg	pass	38105	6492	31613	0
svgs/oxygen-icons-5.113.0/scalable/actions/small/16x16/dialog-cancel.svg	pass	149796	14978	134818	0
svgs/oxygen-icons-5.113.0/scalable/actions/small/16x16/dialog-ok-apply.svg	pass	18919	9645	9274	0
svgs/oxygen-icons-5.113.0/scalable/actions/small/16x16/dialog-ok.svg	pass	20655	9241	11414	0
svgs/oxygen-icons-5.113.0/scalable/actions/small/16x16/distribute-horizontal-center.svg	pass	51686	4719	46967	0
svgs/oxygen-icons-5.113.0/scalable/actions/small/16x16/distribute-horizontal-equal.svg	pass	51201	4664	46537	0
svgs/oxygen-icons-5.113.0/scalable/actions/small/16x16/distribute-horizontal-left.svg	pass	51528	4683	46845	0
svgs/oxygen-icons-5.113.0/scalable/actions/small/16x16/distribute-horizontal-margin.svg	pass	70258	4485	65773	0
svgs/oxygen-icons-5.113.0/scalable/actions/small/16x16/distribute-horizontal-page.svg	pass	36533	11177	25356	0
svgs/oxygen-icons-5.113.0/scalable/actions/small/16x16/distribute-horizontal-right.svg	pass	50993	4469	46524	0
svgs/oxygen-icons-5.113.0/scalable/actions/small/16x16/distribute-horizontal-x.svg	pass	9488	4208	5280	0
svgs/oxygen-icons-5.113.0/scalable/actions/small/16x16/distribute-vertical-bottom.svg	pass	51394	4743	46651	0
svgs/oxygen-icons-5.113.0/scalable/actions/small/16x16/distribute-vertical-center.svg	pass	12173	6222	5951	0
svgs/oxygen-icons-5.113.0/scalable/actions/small/16x16/distribute-vertical-equal.svg	pass	51621	4723	46898	0
svgs/oxygen-icons-5.113.0/scalable/actions/small/16x16/distribute-vertical-margin.svg	pass	10112	4477	5635	0
svgs/oxygen-icons-5.113.0/scalable/actions/small/16x16/distribute-vertical-page.svg	pass	20816	11229	9587	0
svgs/oxygen-icons-5.113.0/scalable/actions/small/16x16/distribute-vertical-top.svg	pass	10198	4754	5444	0
svgs/oxygen-icons-5.113.0/scalable/actions/small/16x16/distribute-vertical-y.svg	pass	9669	4366	5303	0
svgs/oxygen-icons-5.113.0/scalable/actions/small/16x16/document-decrypt.svg	pass	731595	480502	251093	0
svgs/oxygen-icons-5.113.0/scalable/actions/small/16x16/document-edit-decrypt-verify.svg	pass	129245	26887	102358	3
svgs/oxygen-icons-5.113.0/scalable/actions/small/16x16/document-edit-decrypt.svg	mismatch	83699	20919	62780	6
svgs/oxygen-icons-5.113.0/scalable/actions/small/16x16/document-edit-encrypt.svg	mismatch	82648	20458	62190	6
svgs/oxygen-icons-5.113.0/scalable/actions/small/16x16/document-edit-sign-encrypt.svg	pass	112036	15155	96881	3
svgs/oxygen-icons-5.113.0/scalable/actions/small/16x16/document-edit-sign.svg	mismatch	108606	27512	81094	8
svgs/oxygen-icons-5.113.0/scalable/actions/small/16x16/document-edit-verify.svg	mismatch	162120	53151	108969	7
svgs/oxygen-icons-5.113.0/scalable/actions/small/16x16/document-edit.svg	pass	38949	16753	22196	0
svgs/oxygen-icons-5.113.0/scalable/actions/small/16x16/document-encrypt.svg	pass	236546	149258	87288	0
svgs/oxygen-icons-5.113.0/scalable/actions/small/16x16/document-export-table.svg	pass	296350	15417	280933	0
svgs/oxygen-icons-5.113.0/scalable/actions/small/16x16/document-export.svg	pass	22456	8519	13937	0
svgs/oxygen-icons-5.113.0/scalable/actions/small/16x16/document-import.svg	pass	20910	8873	12037	0
svgs/oxygen-icons-5.113.0/scalable/actions/small/16x16/document-new.svg	pass	16509	6875	9634	0
svgs/oxygen-icons-5.113.0/scalable/actions/small/16x16/document-open-data.svg	pass	11932	4097	7835	0
svgs/oxygen-icons-5.113.0/scalable/actions/small/16x16/document-open-folder.svg	pass	1189133	123190	1065943	0
svgs/oxygen-icons-5.113.0/scalable/actions/small/16x16/document-open-recent.svg	pass	20924	9669	11255	2
svgs/oxygen-icons-5.113.0/scalable/actions/small/16x16/document-open-remote.svg	pass	1739365	458648	1280717	1
svgs/oxygen-icons-5.113.0/scalable/actions/small/16x16/document-open.svg	pass	1203554	130990	1072564	0
svgs/oxygen-icons-5.113.0/scalable/actions/small/16x16/document-preview.svg	pass	141027	28745	112282	0
svgs/oxygen-icons-5.113.0/scalable/actions/small/16x16/document-print-direct.svg	pass	416824	31667	385157	0
svgs/oxygen-icons-5.113.0/scalable/actions/small/16x16/document-print-frame.svg	pass	373069	22944	350125	0
svgs/oxygen-icons-5.113.0/scalable/actions/small/16x16/document-print-preview.svg	pass	419392	34333	385059	3
svgs/oxygen-icons-5.113.0/scalable/actions/small/16x16/document-print.svg	pass	367224	21380	345844	0
svgs/oxygen-icons-5.113.0/scalable/actions/small/16x16/document-properties.svg	pass	86697	17437	69260	0
svgs/oxygen-icons-5.113.0/scalable/actions/small/16x16/document-revert.svg	pass	45606	20954	24652	0
svgs/oxygen-icons-5.113.0/scalable/actions/small/16x16/document-save-all.svg	pass	33157	11905	21252	0
svgs/oxygen-icons-5.113.0/scalable/actions/small/16x16/document-save-as.svg	pass	60829	24541	36288	0
svgs/oxygen-icons-5.113.0/scalable/actions/small/16x16/document-save.svg	pass	28696	12354	16342	0
svgs/oxygen-icons-5.113.0/scalable/actions/small/16x16/document-sign.svg	pass	70196	21803	48393	0
svgs/oxygen-icons-5.113.0/scalable/actions/small/16x16/document-swap.svg	pass	19618	2725	16893	0
svgs/oxygen-icons-5.113.0/scalable/actions/small/16x16/documentation.svg	pass	18209	7671	10538	0
svgs/oxygen-icons-5.113.0/scalable/actions/small/16x16/documentinfo.svg	pass	54065	11217	42848	0
svgs/oxygen-icons-5.113.0/scalable/actions/small/16x16/download-later.svg	pass	87585	11783	75802	0
svgs/oxygen-icons-5.113.0/scalable/actions/small/16x16/download.svg	pass	671396	340266	331130	0
svgs/oxygen-icons-5.113.0/scalable/actions/small/16x16/draw-arrow-back.svg	pass	6355	2556	3799	0
svgs/oxygen-icons-5.113.0/scalable/actions/small/16x16/draw-arrow-down.svg	pass	6504	2595	3909	0
svgs/oxygen-icons-5.113.0/scalable/actions/small/16x16/draw-arrow-forward.svg	pass	6438	2572	3866	0
svgs/oxygen-icons-5.113.0/scalable/actions/small/16x16/draw-arrow-up.svg	pass	6577	2599	3978	0
svgs/oxygen-icons-5.113.0/scalable/actions/small/16x16/draw-bezier-curves.svg	pass	5744	1892	3852	0
svgs/oxygen-icons-5.113.0/scalable/actions/small/16x16/draw-brush.svg	pass	37758	14312	23446	0
svgs/oxygen-icons-5.113.0/scalable/actions/small/16x16/draw-circle.svg	pass	6101	2247	3854	0
svgs/oxygen-icons-5.113.0/scalable/actions/small/16x16/draw-cross.svg	pass	6536	2726	3810	0
svgs/oxygen-icons-5.113.0/scalable/actions/small/16x16/draw-donut.svg	pass	6516	2664	3852	0
svgs/oxygen-icons-5.113.0/scalable/actions/small/16x16/draw-ellipse.svg	pass	6130	2273	3857	0
svgs/oxygen-icons-5.113.0/scalable/actions/small/16x16/draw-eraser.svg	pass	78620	5348	73272	1
svgs/oxygen-icons-5.113.0/scalable/actions/small/16x16/draw-freehand.svg	pass	33954	15412	18542	0
svgs/oxygen-icons-5.113.0/scalable/actions/small/16x16/draw-halfcircle1.svg	pass	5667	1896	3771	0
svgs/oxygen-icons-5.113.0/scalable/actions/small/16x16/draw-halfcircle2.png.svg	pass	5719	1944	3775	0
svgs/oxygen-icons-5.113.0/scalable/actions/small/16x16/draw-halfcircle3.svg	pass	5942	2025	3917	0
svgs/oxygen-icons-5.113.0/scalable/actions/small/16x16/draw-halfcircle4.svg	pass	5908	1973	3935	0
svgs/oxygen-icons-5.113.0/scalable/actions/small/16x16/draw-line.svg	pass	3770	873	2897	0
svgs/oxygen-icons-5.113.0/scalable/actions/small/16x16/draw-path.svg	pass	39342	10013	29329	0
svgs/oxygen-icons-5.113.0/scalable/actions/small/16x16/draw-polygon.svg	pass	5829	1948	3881	0
svgs/oxygen-icons-5.113.0/scalable/actions/small/16x16/draw-polyline.png.svg	pass	36515	2012	34503	0
svgs/oxygen-icons-5.113.0/scalable/actions/small/16x16/draw-rectangle.svg	pass	35499	2201	33298	0
svgs/oxygen-icons-5.113.0/scalable/actions/small/16x16/draw-spiral.svg	pass	4948	1166	3782	0
svgs/oxygen-icons-5.113.0/scalable/actions/small/16x16/draw-square-inverted-corners.svg	pass	6604	2730	3874	0
svgs/oxygen-icons-5.113.0/scalable/actions/small/16x16/draw-star.svg	pass	5955	2036	3919	0
svgs/oxygen-icons-5.113.0/scalable/actions/small/16x16/draw-text.svg	pass	8322	1793	6529	0
svgs/oxygen-icons-5.113.0/scalable/actions/small/16x16/draw-triangle.svg	pass	5579	1939	3640	0
svgs/oxygen-icons-5.113.0/scalable/actions/small/16x16/draw-triangle1.svg	pass	35280	1928	33352	0
svgs/oxygen-icons-5.113.0/scalable/actions/small/16x16/draw-triangle2.svg	pass	5915	1961	3954	0
svgs/oxygen-icons-5.113.0/scalable/actions/small/16x16/draw-triangle3.svg	pass	5925	1966	3959	0
svgs/oxygen-icons-5.113.0/scalable/actions/small/16x16/draw-triangle4.svg	pass	5914	1973	3941	0
svgs/oxygen-icons-5.113.0/scalable/actions/small/16x16/edit-clear-history.svg	pass	44867	20535	24332	0
svgs/oxygen-icons-5.113.0/scalable/actions/small/16x16/edit-clear-list.svg	pass	155222	13900	141322	0
svgs/oxygen-icons-5.113.0/scalable/actions/small/16x16/edit-clear-locationbar-rtl.svg	pass	95383	7240	88143	0
svgs/oxygen-icons-5.113.0/scalable/actions/small/16x16/edit-clear.svg	pass	252178	38153	214025	0
svgs/oxygen-icons-5.113.0/scalable/actions/small/16x16/edit-copy.svg	pass	83990	8425	75565	0
svgs/oxygen-icons-5.113.0/scalable/actions/small/16x16/edit-cut.svg	pass	28362	2063	26299	0
svgs/oxygen-icons-5.113.0/scalable/actions/small/16x16/edit-find-mail.svg	pass	124325	22792	101533	0
svgs/oxygen-icons-5.113.0/scalable/actions/small/16x16/edit-find-project.svg	pass	148845	17128	131717	0
svgs/oxygen-icons-5.113.0/scalable/actions/small/16x16/edit-find-replace.svg	pass	43136	21998	21138	0
svgs/oxygen-icons-5.113.0/scalable/actions/small/16x16/edit-find-user.svg	pass	353706	67032	286674	0
svgs/oxygen-icons-5.113.0/scalable/actions/small/16x16/edit-find.svg	pass	93414	17332	76082	0
svgs/oxygen-icons-5.113.0/scalable/actions/small/16x16/edit-guides.svg	pass	26555	3800	22755	0
svgs/oxygen-icons-5.113.0/scalable/actions/small/16x16/edit-image-face-add.svg	mismatch	201127	47059	154068	9
svgs/oxygen-icons-5.113.0/scalable/actions/small/16x16/edit-image-face-detect.svg	pass	17625	3351	14274	0
svgs/oxygen-icons-5.113.0/scalable/actions/small/16x16/edit-image-face-recognize.svg	mismatch	170370	46520	123850	9
svgs/oxygen-icons-5.113.0/scalable/actions/small/16x16/edit-image-face-show.svg	mismatch	160692	42572	118120	9
svgs/oxygen-icons-5.113.0/scalable/actions/small/16x16/edit-link.svg	pass	105764	20345	85419	0
svgs/oxygen-icons-5.113.0/scalable/actions/small/16x16/edit-node.svg	pass	14025	6366	7659	0
svgs/oxygen-icons-5.113.0/scalable/actions/small/16x16/edit-paste.svg	pass	87484	13526	73958	0
svgs/oxygen-icons-5.113.0/scalable/actions/small/16x16/edit-redo.svg	pass	37257	18319	18938	0
svgs/oxygen-icons-5.113.0/scalable/actions/small/16x16/edit-rename.svg	pass	34310	1963	32347	0
svgs/oxygen-icons-5.113.0/scalable/actions/small/16x16/edit-select-all.svg	pass	275499	145598	129901	0
svgs/oxygen-icons-5.113.0/scalable/actions/small/16x16/edit-select-none.svg	pass	286365	148609	137756	0
svgs/oxygen-icons-5.113.0/scalable/actions/small/16x16/edit-select.svg	pass	25146	2721	22425	0
svgs/oxygen-icons-5.113.0/scalable/actions/small/16x16/edit-table-cell-merge.svg	pass	476968	6219	470749	0
svgs/oxygen-icons-5.113.0/scalable/actions/small/16x16/edit-table-cell-split.svg	pass	477214	5888	471326	0
svgs/oxygen-icons-5.113.0/scalable/actions/small/16x16/edit-table-delete-column.svg	pass	486490	8941	477549	0
svgs/oxygen-icons-5.113.0/scalable/actions/small/16x16/edit-table-insert-column-left.svg	pass	800512	14804	785708	0
svgs/oxygen-icons-5.113.0/scalable/actions/small/16x16/edit-table-insert-column-right.svg	pass	809285	14959	794326	0
svgs/oxygen-icons-5.113.0/scalable/actions/small/16x16/edit-table-insert-row-above.svg	pass	961179	14844	946335	0
svgs/oxygen-icons-5.113.0/scalable/actions/small/16x16/edit-table-insert-row-below.svg	pass	961117	14824	946293	0
svgs/oxygen-icons-5.113.0/scalable/actions/small/16x16/edit-text-frame-update.svg	pass	12210	3885	8325	0
svgs/oxygen-icons-5.113.0/scalable/actions/small/16x16/edit-undo.svg	pass	37637	18276	19361	0
svgs/oxygen-icons-5.113.0/scalable/actions/small/16x16/folder-new.svg	pass	1195796	126773	1069023	0
svgs/oxygen-icons-5.113.0/scalable/actions/small/16x16/folder-sync.svg	pass	20709	3631	17078	0
svgs/oxygen-icons-5.113.0/scalable/actions/small/16x16/format-add-node.svg	pass	32149	11717	20432	0
svgs/oxygen-icons-5.113.0/scalable/actions/small/16x16/format-break-node.svg	pass	15283	5237	10046	0
svgs/oxygen-icons-5.113.0/scalable/actions/small/16x16/format-connect-node.svg	pass	18355	6970	11385	0
svgs/oxygen-icons-5.113.0/scalable/actions/small/16x16/format-disconnect-node.svg	pass	17387	6971	10416	0
svgs/oxygen-icons-5.113.0/scalable/actions/small/16x16/format-join-node.svg	pass	14100	5369	8731	0
svgs/oxygen-icons-5.113.0/scalable/actions/small/16x16/format-remove-node.svg	pass	36215	11843	24372	0
svgs/oxygen-icons-5.113.0/scalable/actions/small/16x16/games-achievements.svg	pass	644184	140234	503950	0
svgs/oxygen-icons-5.113.0/scalable/actions/small/16x16/games-highscores.svg	pass	291550	144398	147152	0
svgs/oxygen-icons-5.113.0/scalable/actions/small/16x16/go-down-search.svg	pass	9786	2518	7268	0
svgs/oxygen-icons-5.113.0/scalable/actions/small/16x16/go-down.svg	pass	28340	4771	23569	0
svgs/oxygen-icons-5.113.0/scalable/actions/small/16x16/go-first-view-page.svg	pass	105628	24862	80766	0
svgs/oxygen-icons-5.113.0/scalable/actions/small/16x16/go-first-view.svg	pass	16522	9010	7512	0
svgs/oxygen-icons-5.113.0/scalable/actions/small/16x16/go-home.svg	pass	25586	6512	19074	0
svgs/oxygen-icons-5.113.0/scalable/actions/small/16x16/go-jump-declaration.svg	pass	58802	13853	44949	0
svgs/oxygen-icons-5.113.0/scalable/actions/small/16x16/go-jump-definition.svg	pass	102430	3169	99261	0
svgs/oxygen-icons-5.113.0/scalable/actions/small/16x16/go-jump-locationbar.svg	pass	637592	337984	299608	0
svgs/oxygen-icons-5.113.0/scalable/actions/small/16x16/go-jump-today.svg	pass	98586	36564	62022	0
svgs/oxygen-icons-5.113.0/scalable/actions/small/16x16/go-last-view-page.svg	pass	105308	24818	80490	0
svgs/oxygen-icons-5.113.0/scalable/actions/small/16x16/go-last-view.svg	pass	20008	9051	10957	0
svgs/oxygen-icons-5.113.0/scalable/actions/small/16x16/go-next-context.svg	pass	20518	8223	12295	0
svgs/oxygen-icons-5.113.0/scalable/actions/small/16x16/go-next-use.svg	pass	37146	5337	31809	0
svgs/oxygen-icons-5.113.0/scalable/actions/small/16x16/go-next-view-page.svg	pass	40254	17804	22450	0
svgs/oxygen-icons-5.113.0/scalable/actions/small/16x16/go-next-view.svg	pass	4411	2589	1822	0
svgs/oxygen-icons-5.113.0/scalable/actions/small/16x16/go-next.svg	pass	27608	4799	22809	0
svgs/oxygen-icons-5.113.0/scalable/actions/small/16x16/go-parent-folder.svg	pass	10860	3883	6977	0
svgs/oxygen-icons-5.113.0/scalable/actions/small/16x16/go-previous-context.svg	pass	17064	7491	9573	0
svgs/oxygen-icons-5.113.0/scalable/actions/small/16x16/go-previous-use.svg	pass	110763	5472	105291	0
svgs/oxygen-icons-5.113.0/scalable/actions/small/16x16/go-previous-view-page.svg	pass	40315	17633	22682	0
svgs/oxygen-icons-5.113.0/scalable/actions/small/16x16/go-previous-view.svg	pass	4528	2655	1873	0
svgs/oxygen-icons-5.113.0/scalable/actions/small/16x16/go-previous.svg	pass	25144	4830	20314	0
svgs/oxygen-icons-5.113.0/scalable/actions/small/16x16/go-up-search.svg	pass	10427	2563	7864	0
svgs/oxygen-icons-5.113.0/scalable/actions/small/16x16/go-up.svg	pass	27563	4938	22625	0
svgs/oxygen-icons-5.113.0/scalable/actions/small/16x16/help-about.svg	pass	107230	11396	95834	2
svgs/oxygen-icons-5.113.0/scalable/actions/small/16x16/help-contents.svg	pass	805625	577702	227923	0
svgs/oxygen-icons-5.113.0/scalable/actions/small/16x16/help-contextual.svg	pass	317877	14827	303050	0
svgs/oxygen-icons-5.113.0/scalable/actions/small/16x16/help-donate.svg	pass	144998	13626	131372	0
svgs/oxygen-icons-5.113.0/scalable/actions/small/16x16/help-feedback.svg	pass	118766	16874	101892	2
svgs/oxygen-icons-5.113.0/scalable/actions/small/16x16/im-aim.svg	pass	35478	14507	20971	0
svgs/oxygen-icons-5.113.0/scalable/actions/small/16x16/im-ban-kick-user.svg	pass	108592	51730	56862	2
svgs/oxygen-icons-5.113.0/scalable/actions/small/16x16/im-ban-user.svg	mismatch	61236	29848	31388	30
svgs/oxygen-icons-5.113.0/scalable/actions/small/16x16/im-facebook.svg	pass	9873	3928	5945	0
svgs/oxygen-icons-5.113.0/scalable/actions/small/16x16/im-icq.svg	pass	74460	25036	49424	0
svgs/oxygen-icons-5.113.0/scalable/actions/small/16x16/im-identi.ca.svg	pass	37892	21463	16429	0
svgs/oxygen-icons-5.113.0/scalable/actions/small/16x16/im-jabber.svg	pass	52295	16196	36099	0
svgs/oxygen-icons-5.113.0/scalable/actions/small/16x16/im-kick-user.svg	pass	241592	29408	212184	0
svgs/oxygen-icons-5.113.0/scalable/actions/small/16x16/im-msn.svg	pass	78634	26004	52630	0
svgs/oxygen-icons-5.113.0/scalable/actions/small/16x16/im-qq.svg	pass	56948	18842	38106	2
svgs/oxygen-icons-5.113.0/scalable/actions/small/16x16/im-skype.svg	pass	43838	7964	35874	0
svgs/oxygen-icons-5.113.0/scalable/actions/small/16x16/im-twitter.svg	pass	12972	3884	9088	0
svgs/oxygen-icons-5.113.0/scalable/actions/small/16x16/im-user-busy.svg	pass	67312	35780	31532	1
svgs/oxygen-icons-5.113.0/scalable/actions/small/16x16/im-yahoo.svg	mismatch	57148	20770	36378	6
svgs/oxygen-icons-5.113.0/scalable/actions/small/16x16/insert-button.svg	pass	10267	4590	5677	0
svgs/oxygen-icons-5.113.0/scalable/actions/small/16x16/insert-horizontal-rule.svg	pass	220786	13862	206924	0
svgs/oxygen-icons-5.113.0/scalable/actions/small/16x16/insert-image.svg	pass	929941	562355	367586	0
svgs/oxygen-icons-5.113.0/scalable/actions/small/16x16/insert-link.svg	pass	199645	17021	182624	0
svgs/oxygen-icons-5.113.0/scalable/actions/small/16x16/insert-table.svg	pass	40085	15955	24130	0
svgs/oxygen-icons-5.113.0/scalable/actions/small/16x16/insert-text.svg	pass	37509	14002	23507	0
svgs/oxygen-icons-5.113.0/scalable/actions/small/16x16/irc-close-channel.svg	mismatch	67137	36546	30591	8
svgs/oxygen-icons-5.113.0/scalable/actions/small/16x16/irc-join-channel.svg	pass	273900	34058	239842	4
svgs/oxygen-icons-5.113.0/scalable/actions/small/16x16/irc-operator.svg	pass	92794	45150	47644	0
svgs/oxygen-icons-5.113.0/scalable/actions/small/16x16/irc-remove-operator.svg	mismatch	114104	41287	72817	43
svgs/oxygen-icons-5.113.0/scalable/actions/small/16x16/irc-unvoice.svg	mismatch	60877	28825	32052	11
svgs/oxygen-icons-5.113.0/scalable/actions/small/16x16/irc-voice.svg	pass	31871	16203	15668	0
svgs/oxygen-icons-5.113.0/scalable/actions/small/16x16/key-enter.svg	pass	144802	3535	141267	0
svgs/oxygen-icons-5.113.0/scalable/actions/small/16x16/kmix-master.svg	pass	12677	4463	8214	0
svgs/oxygen-icons-5.113.0/scalable/actions/small/16x16/list-add-font.svg	pass	229879	16074	213805	0
svgs/oxygen-icons-5.113.0/scalable/actions/small/16x16/list-add-user.svg	mismatch	193773	54345	139428	9
svgs/oxygen-icons-5.113.0/scalable/actions/small/16x16/list-add.svg	pass	21018	10341	10677	0
svgs/oxygen-icons-5.113.0/scalable/actions/small/16x16/list-remove.svg	pass	14011	6107	7904	0
svgs/oxygen-icons-5.113.0/scalable/actions/small/16x16/list-resource-add.svg	pass	173197	145960	27237	0
svgs/oxygen-icons-5.113.0/scalable/actions/small/16x16/mail-encrypted-full.svg	mismatch	26885	10086	16799	20
svgs/oxygen-icons-5.113.0/scalable/actions/small/16x16/mail-encrypted-part.svg	mismatch	86063	10801	75262	11
svgs/oxygen-icons-5.113.0/scalable/actions/small/16x16/mail-encrypted.svg	mismatch	26858	9939	16919	18
svgs/oxygen-icons-5.113.0/scalable/actions/small/16x16/mail-flag.svg	pass	70424	37675	32749	0
svgs/oxygen-icons-5.113.0/scalable/actions/small/16x16/mail-forward.svg	pass	89131	4599	84532	0
svgs/oxygen-icons-5.113.0/scalable/actions/small/16x16/mail-invitation.svg	pass	194129	10721	183408	0
svgs/oxygen-icons-5.113.0/scalable/actions/small/16x16/mail-mark-important.svg	pass	516143	10168	505975	0
svgs/oxygen-icons-5.113.0/scalable/actions/small/16x16/mail-mark-junk.svg	pass	515083	6480	508603	0
svgs/oxygen-icons-5.113.0/scalable/actions/small/16x16/mail-mark-notjunk.svg	pass	19671	8496	11175	0
svgs/oxygen-icons-5.113.0/scalable/actions/small/16x16/mail-mark-read.svg	pass	88602	13300	75302	0
svgs/oxygen-icons-5.113.0/scalable/actions/small/16x16/mail-mark-unread-new.svg	pass	807929	8267	799662	0
svgs/oxygen-icons-5.113.0/scalable/actions/small/16x16/mail-mark-unread.svg	pass	69643	4736	64907	0
svgs/oxygen-icons-5.113.0/scalable/actions/small/16x16/mail-meeting-request-reply.svg	pass	63988	5443	58545	0
svgs/oxygen-icons-5.113.0/scalable/actions/small/16x16/mail-message-new-list.svg	pass	143399	18168	125231	0
svgs/oxygen-icons-5.113.0/scalable/actions/small/16x16/mail-message-new.svg	pass	141892	19552	122340	0
svgs/oxygen-icons-5.113.0/scalable/actions/small/16x16/mail-queue.svg	pass	79675	5795	73880	0
svgs/oxygen-icons-5.113.0/scalable/actions/small/16x16/mail-receive.svg	pass	152805	5931	146874	0
svgs/oxygen-icons-5.113.0/scalable/actions/small/16x16/mail-replied.svg	pass	145769	14481	131288	0
svgs/oxygen-icons-5.113.0/scalable/actions/small/16x16/mail-reply-all.svg	pass	69295	5929	63366	0
svgs/oxygen-icons-5.113.0/scalable/actions/small/16x16/mail-reply-custom-all.svg	pass	59978	2963	57015	0
svgs/oxygen-icons-5.113.0/scalable/actions/small/16x16/mail-reply-custom.svg	pass	59693	2813	56880	0
svgs/oxygen-icons-5.113.0/scalable/actions/small/16x16/mail-reply-list.svg	pass	257203	16935	240268	0
svgs/oxygen-icons-5.113.0/scalable/actions/small/16x16/mail-reply-sender.svg	pass	65002	5452	59550	0
svgs/oxygen-icons-5.113.0/scalable/actions/small/16x16/mail-send.svg	pass	30219	11498	18721	0
svgs/oxygen-icons-5.113.0/scalable/actions/small/16x16/mail-signature-unknown.svg	mismatch	27267	11035	16232	15
svgs/oxygen-icons-5.113.0/scalable/actions/small/16x16/mail-signed-full.svg	mismatch	7495	3033	4462	28
svgs/oxygen-icons-5.113.0/scalable/actions/small/16x16/mail-signed-part.svg	mismatch	8240	3383	4857	19
svgs/oxygen-icons-5.113.0/scalable/actions/small/16x16/mail-signed-verified.svg	pass	94919	24713	70206	1
svgs/oxygen-icons-5.113.0/scalable/actions/small/16x16/mail-signed.svg	mismatch	7099	3044	4055	29
svgs/oxygen-icons-5.113.0/scalable/actions/small/16x16/mail-tagged.svg	mismatch	8775	3119	5656	29
svgs/oxygen-icons-5.113.0/scalable/actions/small/16x16/measure.svg	pass	11919	4172	7747	0
svgs/oxygen-icons-5.113.0/scalable/actions/small/16x16/meeting-participant-no-response.svg	pass	339202	149374	189828	0
svgs/oxygen-icons-5.113.0/scalable/actions/small/16x16/meeting-participant-request-response.svg	pass	339311	149142	190169	0
svgs/oxygen-icons-5.113.0/scalable/actions/small/16x16/milestone.svg	pass	365120	118361	246759	0
svgs/oxygen-icons-5.113.0/scalable/actions/small/16x16/network-connect.svg	pass	61370	20174	41196	0
svgs/oxygen-icons-5.113.0/scalable/actions/small/16x16/news-subscribe.svg	pass	176559	18602	157957	0
svgs/oxygen-icons-5.113.0/scalable/actions/small/16x16/news-unsubscribe.svg	pass	360667	20532	340135	0
svgs/oxygen-icons-5.113.0/scalable/actions/small/16x16/object-flip-horizontal.svg	pass	64172	8864	55308	0
svgs/oxygen-icons-5.113.0/scalable/actions/small/16x16/object-flip-vertical.svg	pass	47172	5489	41683	0
svgs/oxygen-icons-5.113.0/scalable/actions/small/16x16/object-group.svg	pass	33560	5734	27826	0
svgs/oxygen-icons-5.113.0/scalable/actions/small/16x16/object-order-back.svg	pass	84368	5605	78763	0
svgs/oxygen-icons-5.113.0/scalable/actions/small/16x16/object-order-front.svg	pass	35754	5605	30149	0
svgs/oxygen-icons-5.113.0/scalable/actions/small/16x16/object-order-lower.svg	pass	45051	17045	28006	0
svgs/oxygen-icons-5.113.0/scalable/actions/small/16x16/object-order-raise.svg	pass	26619	4218	22401	0
svgs/oxygen-icons-5.113.0/scalable/actions/small/16x16/object-rotate-left.svg	pass	5926	2154	3772	0
svgs/oxygen-icons-5.113.0/scalable/actions/small/16x16/object-rotate-right.svg	pass	5247	2109	3138	0
svgs/oxygen-icons-5.113.0/scalable/actions/small/16x16/object-ungroup.svg	pass	29476	5764	23712	0
svgs/oxygen-icons-5.113.0/scalable/actions/small/16x16/office-chart-area-focus-peak-node.svg	pass	11207	4771	6436	0
svgs/oxygen-icons-5.113.0/scalable/actions/small/16x16/office-chart-area-percentage.svg	pass	15087	5582	9505	0
svgs/oxygen-icons-5.113.0/scalable/actions/small/16x16/office-chart-area-stacked.svg	pass	10889	5367	5522	0
svgs/oxygen-icons-5.113.0/scalable/actions/small/16x16/office-chart-area.svg	pass	10818	4521	6297	0
svgs/oxygen-icons-5.113.0/scalable/actions/small/16x16/office-chart-bar-percentage.svg	pass	147730	9270	138460	0
svgs/oxygen-icons-5.113.0/scalable/actions/small/16x16/office-chart-bar-stacked.svg	pass	83529	8781	74748	0
svgs/oxygen-icons-5.113.0/scalable/actions/small/16x16/office-chart-bar.svg	pass	74114	5559	68555	0
svgs/oxygen-icons-5.113.0/scalable/actions/small/16x16/office-chart-line-percentage.svg	pass	73147	4500	68647	0
svgs/oxygen-icons-5.113.0/scalable/actions/small/16x16/office-chart-line-stacked.svg	pass	71516	3382	68134	0
svgs/oxygen-icons-5.113.0/scalable/actions/small/16x16/office-chart-line.svg	pass	71494	3379	68115	0
svgs/oxygen-icons-5.113.0/scalable/actions/small/16x16/office-chart-pie.svg	pass	137831	18955	118876	0
svgs/oxygen-icons-5.113.0/scalable/actions/small/16x16/office-chart-polar-stacked.svg	pass	11503	3247	8256	0
svgs/oxygen-icons-5.113.0/scalable/actions/small/16x16/office-chart-polar.svg	pass	69032	2229	66803	0
svgs/oxygen-icons-5.113.0/scalable/actions/small/16x16/office-chart-scatter.svg	pass	70631	4085	66546	0
svgs/oxygen-icons-5.113.0/scalable/actions/small/16x16/page-2sides.svg	pass	6935	2865	4070	0
svgs/oxygen-icons-5.113.0/scalable/actions/small/16x16/page-3sides.svg	pass	6415	2586	3829	0
svgs/oxygen-icons-5.113.0/scalable/actions/small/16x16/page-4sides.svg	pass	9356	4431	4925	0
svgs/oxygen-icons-5.113.0/scalable/actions/small/16x16/page-simple.svg	pass	35097	1607	33490	0
svgs/oxygen-icons-5.113.0/scalable/actions/small/16x16/page-zoom.svg	pass	98595	17709	80886	0
svgs/oxygen-icons-5.113.0/scalable/actions/small/16x16/pdf-annotations.svg	pass	21465	5875	15590	0
svgs/oxygen-icons-5.113.0/scalable/actions/small/16x16/preferences-activities.svg	pass	520924	13011	507913	0
svgs/oxygen-icons-5.113.0/scalable/actions/small/16x16/preflight-verifier.svg	pass	852314	554386	297928	0
svgs/oxygen-icons-5.113.0/scalable/actions/small/16x16/process-stop.svg	pass	18598	9355	9243	0
svgs/oxygen-icons-5.113.0/scalable/actions/small/16x16/project-development-close-all.svg	pass	51095	6470	44625	0
svgs/oxygen-icons-5.113.0/scalable/actions/small/16x16/project-development-close.svg	pass	47735	4671	43064	0
svgs/oxygen-icons-5.113.0/scalable/actions/small/16x16/project-development-new-template.svg	pass	110151	6011	104140	0
svgs/oxygen-icons-5.113.0/scalable/actions/small/16x16/project-development.svg	pass	81021	5822	75199	0
svgs/oxygen-icons-5.113.0/scalable/actions/small/16x16/project-open.svg	pass	1094569	126188	968381	0
svgs/oxygen-icons-5.113.0/scalable/actions/small/16x16/quickopen-class.svg	pass	62146	18409	43737	0
svgs/oxygen-icons-5.113.0/scalable/actions/small/16x16/quickopen-file.svg	pass	30821	15213	15608	0
svgs/oxygen-icons-5.113.0/scalable/actions/small/16x16/quickopen-function.svg	pass	96853	16930	79923	0
svgs/oxygen-icons-5.113.0/scalable/actions/small/16x16/quickopen.svg	pass	27518	10574	16944	0
svgs/oxygen-icons-5.113.0/scalable/actions/small/16x16/rating.svg	pass	42525	19638	22887	0
svgs/oxygen-icons-5.113.0/scalable/actions/small/16x16/resource-calendar-child-insert.svg	pass	55730	13279	42451	0
svgs/oxygen-icons-5.113.0/scalable/actions/small/16x16/resource-calendar-child.svg	pass	47920	9809	38111	0
svgs/oxygen-icons-5.113.0/scalable/actions/small/16x16/resource-calendar-insert.svg	pass	93267	37966	55301	0
svgs/oxygen-icons-5.113.0/scalable/actions/small/16x16/resource-group-new.svg	pass	208471	150408	58063	0
svgs/oxygen-icons-5.113.0/scalable/actions/small/16x16/run-build-clean.svg	pass	256810	61558	195252	0
svgs/oxygen-icons-5.113.0/scalable/actions/small/16x16/run-build-configure.svg	pass	279991	62642	217349	1
svgs/oxygen-icons-5.113.0/scalable/actions/small/16x16/run-build-file.svg	pass	417973	45144	372829	0
svgs/oxygen-icons-5.113.0/scalable/actions/small/16x16/run-build-install-root.svg	pass	227535	43395	184140	0
svgs/oxygen-icons-5.113.0/scalable/actions/small/16x16/run-build-install.svg	pass	355713	44772	310941	0
svgs/oxygen-icons-5.113.0/scalable/actions/small/16x16/run-build-prune.svg	pass	286342	81666	204676	0
svgs/oxygen-icons-5.113.0/scalable/actions/small/16x16/run-build.svg	pass	225307	38977	186330	0
svgs/oxygen-icons-5.113.0/scalable/actions/small/16x16/select-rectangular.svg	pass	37435	16700	20735	0
svgs/oxygen-icons-5.113.0/scalable/actions/small/16x16/show-menu.svg	pass	4961	1664	3297	0
svgs/oxygen-icons-5.113.0/scalable/actions/small/16x16/snap-extension.svg	pass	30333	14289	16044	0
svgs/oxygen-icons-5.113.0/scalable/actions/small/16x16/snap-guideline.svg	pass	18995	6601	12394	0
svgs/oxygen-icons-5.113.0/scalable/actions/small/16x16/snap-intersection.svg	pass	14134	5486	8648	0
svgs/oxygen-icons-5.113.0/scalable/actions/small/16x16/snap-node.svg	pass	23689	11222	12467	0
svgs/oxygen-icons-5.113.0/scalable/actions/small/16x16/snap-orthogonal.svg	pass	16594	5382	11212	0
svgs/oxygen-icons-5.113.0/scalable/actions/small/16x16/story-editor.svg	pass	42376	21038	21338	0
svgs/oxygen-icons-5.113.0/scalable/actions/small/16x16/stroke-cap-butt.svg	pass	7597	2930	4667	0
svgs/oxygen-icons-5.113.0/scalable/actions/small/16x16/stroke-cap-round.svg	pass	8277	3345	4932	0
svgs/oxygen-icons-5.113.0/scalable/actions/small/16x16/stroke-cap-square.png.svg	pass	9041	3141	5900	0
svgs/oxygen-icons-5.113.0/scalable/actions/small/16x16/stroke-join-bevel.svg	pass	15609	3819	11790	0
svgs/oxygen-icons-5.113.0/scalable/actions/small/16x16/stroke-join-miter.svg	pass	9018	3810	5208	0
svgs/oxygen-icons-5.113.0/scalable/actions/small/16x16/stroke-join-round.svg	pass	9504	4185	5319	0
svgs/oxygen-icons-5.113.0/scalable/actions/small/16x16/system-run.svg	pass	337278	19187	318091	0
svgs/oxygen-icons-5.113.0/scalable/actions/small/16x16/system-search.svg	pass	120205	23544	96661	0
svgs/oxygen-icons-5.113.0/scalable/actions/small/16x16/tab-close.svg	pass	206040	15645	190395	0
svgs/oxygen-icons-5.113.0/scalable/actions/small/16x16/tab-detach.svg	pass	39461	7601	31860	0
svgs/oxygen-icons-5.113.0/scalable/actions/small/16x16/tab-duplicate.svg	pass	43141	6357	36784	0
svgs/oxygen-icons-5.113.0/scalable/actions/small/16x16/tab-new-background.svg	pass	18320	5946	12374	0
svgs/oxygen-icons-5.113.0/scalable/actions/small/16x16/tab-new.svg	pass	48819	8416	40403	0
svgs/oxygen-icons-5.113.0/scalable/actions/small/16x16/text-completion.svg	pass	41699	6169	35530	0
svgs/oxygen-icons-5.113.0/scalable/actions/small/16x16/text-field.svg	pass	6208	2004	4204	0
svgs/oxygen-icons-5.113.0/scalable/actions/small/16x16/text-frame-link.svg	pass	16102	6982	9120	0
svgs/oxygen-icons-5.113.0/scalable/actions/small/16x16/text-frame-unlink.svg	pass	15960	6826	9134	0
svgs/oxygen-icons-5.113.0/scalable/actions/small/16x16/text-speak.svg	pass	13650	7269	6381	0
svgs/oxygen-icons-5.113.0/scalable/actions/small/16x16/tool-animator.svg	pass	27487	12754	14733	0
svgs/oxygen-icons-5.113.0/scalable/actions/small/16x16/tools-check-spelling.svg	pass	25108	12283	12825	0
svgs/oxygen-icons-5.113.0/scalable/actions/small/16x16/tools-media-optical-burn-image.svg	pass	884024	140298	743726	0
svgs/oxygen-icons-5.113.0/scalable/actions/small/16x16/tools-media-optical-burn.svg	pass	845007	140549	704458	0
svgs/oxygen-icons-5.113.0/scalable/actions/small/16x16/tools-media-optical-copy.svg	pass	1670117	242182	1427935	0
svgs/oxygen-icons-5.113.0/scalable/actions/small/16x16/tools-media-optical-erase.svg	pass	173389	19100	154289	0
svgs/oxygen-icons-5.113.0/scalable/actions/small/16x16/tools-media-optical-format.svg	pass	62135	32890	29245	0
svgs/oxygen-icons-5.113.0/scalable/actions/small/16x16/tools-rip-audio-cd.svg	pass	855654	131541	724113	0
svgs/oxygen-icons-5.113.0/scalable/actions/small/16x16/tools-rip-video-cd.svg	pass	48380	25339	23041	0
svgs/oxygen-icons-5.113.0/scalable/actions/small/16x16/tools-rip-video-dvd.svg	pass	62660	26984	35676	0
svgs/oxygen-icons-5.113.0/scalable/actions/small/16x16/transform-crop-and-resize.svg	pass	169135	14345	154790	0
svgs/oxygen-icons-5.113.0/scalable/actions/small/16x16/transform-crop.svg	pass	168848	14094	154754	0
svgs/oxygen-icons-5.113.0/scalable/actions/small/16x16/transform-rotate.svg	pass	11283	5173	6110	0
svgs/oxygen-icons-5.113.0/scalable/actions/small/16x16/transform-scale.svg	pass	17564	5171	12393	0
svgs/oxygen-icons-5.113.0/scalable/actions/small/16x16/transform-shear-down.svg	pass	10108	4406	5702	0
svgs/oxygen-icons-5.113.0/scalable/actions/small/16x16/transform-shear-left.svg	pass	10081	4400	5681	0
svgs/oxygen-icons-5.113.0/scalable/actions/small/16x16/transform-shear-right.svg	pass	10307	4358	5949	0
svgs/oxygen-icons-5.113.0/scalable/actions/small/16x16/transform-shear-up.svg	pass	10105	4405	5700	0
svgs/oxygen-icons-5.113.0/scalable/actions/small/16x16/trash-empty.svg	pass	253726	10403	243323	0
svgs/oxygen-icons-5.113.0/scalable/actions/small/16x16/user-group-delete.svg	pass	949594	139794	809800	0
svgs/oxygen-icons-5.113.0/scalable/actions/small/16x16/user-group-new.svg	pass	560501	91993	468508	0
svgs/oxygen-icons-5.113.0/scalable/actions/small/16x16/user-group-properties.svg	pass	892720	152377	740343	0
svgs/oxygen-icons-5.113.0/scalable/actions/small/16x16/user-properties.svg	pass	342736	63970	278766	1
svgs/oxygen-icons-5.113.0/scalable/actions/small/16x16/view-barcode-add.svg	pass	210459	7402	203057	0
svgs/oxygen-icons-5.113.0/scalable/actions/small/16x16/view-barcode.svg	pass	70368	2980	67388	0
svgs/oxygen-icons-5.113.0/scalable/actions/small/16x16/view-calendar-agenda.svg	pass	42867	7281	35586	0
svgs/oxygen-icons-5.113.0/scalable/actions/small/16x16/view-calendar-birthday.svg	pass	21241	9459	11782	0
svgs/oxygen-icons-5.113.0/scalable/actions/small/16x16/view-calendar-day.svg	pass	71585	35538	36047	0
svgs/oxygen-icons-5.113.0/scalable/actions/small/16x16/view-calendar-holiday.svg	pass	16452	5873	10579	0
svgs/oxygen-icons-5.113.0/scalable/actions/small/16x16/view-calendar-journal.svg	pass	284784	37328	247456	0
svgs/oxygen-icons-5.113.0/scalable/actions/small/16x16/view-calendar-list.svg	pass	78190	9947	68243	2
svgs/oxygen-icons-5.113.0/scalable/actions/small/16x16/view-calendar-month.svg	pass	92647	47295	45352	0
svgs/oxygen-icons-5.113.0/scalable/actions/small/16x16/view-calendar-special-occasion.svg	pass	96785	48356	48429	0
svgs/oxygen-icons-5.113.0/scalable/actions/small/16x16/view-calendar-tasks.svg	pass	99216	15573	83643	0
svgs/oxygen-icons-5.113.0/scalable/actions/small/16x16/view-calendar-time-spent.svg	pass	231904	50182	181722	0
svgs/oxygen-icons-5.113.0/scalable/actions/small/16x16/view-calendar-timeline.svg	pass	40203	3640	36563	0
svgs/oxygen-icons-5.113.0/scalable/actions/small/16x16/view-calendar-upcoming-days.svg	pass	73641	36820	36821	0
svgs/oxygen-icons-5.113.0/scalable/actions/small/16x16/view-calendar-upcoming-events.svg	pass	77039	35055	41984	0
svgs/oxygen-icons-5.113.0/scalable/actions/small/16x16/view-calendar-wedding-anniversary.svg	pass	33105	10786	22319	0
svgs/oxygen-icons-5.113.0/scalable/actions/small/16x16/view-calendar-week.svg	pass	77755	39384	38371	0
svgs/oxygen-icons-5.113.0/scalable/actions/small/16x16/view-calendar-whatsnext.svg	pass	196539	56186	140353	0
svgs/oxygen-icons-5.113.0/scalable/actions/small/16x16/view-calendar-workweek.svg	pass	75697	38102	37595	0
svgs/oxygen-icons-5.113.0/scalable/actions/small/16x16/view-calendar.svg	pass	84710	34929	49781	0
svgs/oxygen-icons-5.113.0/scalable/actions/small/16x16/view-certificate-add.svg	pass	976297	59429	916868	0
svgs/oxygen-icons-5.113.0/scalable/actions/small/16x16/view-certificate-export-secret.svg	pass	228108	41098	187010	0
svgs/oxygen-icons-5.113.0/scalable/actions/small/16x16/view-certificate-export-server.svg	pass	918510	384157	534353	0
svgs/oxygen-icons-5.113.0/scalable/actions/small/16x16/view-certificate-export.svg	pass	178545	50897	127648	0
svgs/oxygen-icons-5.113.0/scalable/actions/small/16x16/view-certificate-import.svg	pass	333584	19522	314062	0
svgs/oxygen-icons-5.113.0/scalable/actions/small/16x16/view-certificate-server-configure.svg	pass	1183916	408200	775716	0
svgs/oxygen-icons-5.113.0/scalable/actions/small/16x16/view-certificate-sign.svg	pass	233261	25964	207297	0
svgs/oxygen-icons-5.113.0/scalable/actions/small/16x16/view-certificate.svg	pass	183089	53141	129948	0
svgs/oxygen-icons-5.113.0/scalable/actions/small/16x16/view-choose.svg	pass	82670	6843	75827	0
svgs/oxygen-icons-5.113.0/scalable/actions/small/16x16/view-close.svg	pass	77750	2678	75072	0
svgs/oxygen-icons-5.113.0/scalable/actions/small/16x16/view-file-columns.svg	pass	76843	5846	70997	0
svgs/oxygen-icons-5.113.0/scalable/actions/small/16x16/view-filter.svg	pass	29025	10714	18311	4
svgs/oxygen-icons-5.113.0/scalable/actions/small/16x16/view-financial-forecast.svg	pass	16862	8683	8179	0
svgs/oxygen-icons-5.113.0/scalable/actions/small/16x16/view-form-action.svg	pass	98636	15849	82787	0
svgs/oxygen-icons-5.113.0/scalable/actions/small/16x16/view-form-table.svg	pass	36675	2401	34274	0
svgs/oxygen-icons-5.113.0/scalable/actions/small/16x16/view-form.svg	pass	77764	5947	71817	0
svgs/oxygen-icons-5.113.0/scalable/actions/small/16x16/view-fullscreen.svg	pass	290747	2028	288719	0
svgs/oxygen-icons-5.113.0/scalable/actions/small/16x16/view-grid.svg	pass	29069	3552	25517	0
svgs/oxygen-icons-5.113.0/scalable/actions/small/16x16/view-group.svg	pass	79492	7938	71554	0
svgs/oxygen-icons-5.113.0/scalable/actions/small/16x16/view-history.svg	pass	40836	19181	21655	0
svgs/oxygen-icons-5.113.0/scalable/actions/small/16x16/view-ldap-resource.svg	pass	1734692	886354	848338	2
svgs/oxygen-icons-5.113.0/scalable/actions/small/16x16/view-left-close.svg	pass	77567	6189	71378	0
svgs/oxygen-icons-5.113.0/scalable/actions/small/16x16/view-list-details.svg	pass	80621	7546	73075	0
svgs/oxygen-icons-5.113.0/scalable/actions/small/16x16/view-list-icons.svg	pass	81467	7254	74213	0
svgs/oxygen-icons-5.113.0/scalable/actions/small/16x16/view-list-text.svg	pass	76924	5546	71378	0
svgs/oxygen-icons-5.113.0/scalable/actions/small/16x16/view-list-tree.svg	pass	81339	6738	74601	0
svgs/oxygen-icons-5.113.0/scalable/actions/small/16x16/view-media-artist.svg	pass	8338	3148	5190	0
svgs/oxygen-icons-5.113.0/scalable/actions/small/16x16/view-media-lyrics.svg	pass	173353	31102	142251	0
svgs/oxygen-icons-5.113.0/scalable/actions/small/16x16/view-media-playlist.svg	pass	141311	24847	116464	0
svgs/oxygen-icons-5.113.0/scalable/actions/small/16x16/view-multiple-objects.svg	pass	11012	4003	7009	0
svgs/oxygen-icons-5.113.0/scalable/actions/small/16x16/view-pim-calendar.svg	pass	34358	3742	30616	0
svgs/oxygen-icons-5.113.0/scalable/actions/small/16x16/view-pim-contacts.svg	pass	76789	36349	40440	1
svgs/oxygen-icons-5.113.0/scalable/actions/small/16x16/view-pim-journal.svg	pass	100968	22795	78173	0
svgs/oxygen-icons-5.113.0/scalable/actions/small/16x16/view-pim-mail.svg	pass	214275	46363	167912	0
svgs/oxygen-icons-5.113.0/scalable/actions/small/16x16/view-pim-news.svg	pass	161386	9086	152300	0
svgs/oxygen-icons-5.113.0/scalable/actions/small/16x16/view-pim-notes.svg	pass	282069	3754	278315	0
svgs/oxygen-icons-5.113.0/scalable/actions/small/16x16/view-pim-tasks-pending.svg	pass	135729	30248	105481	0
svgs/oxygen-icons-5.113.0/scalable/actions/small/16x16/view-pim-tasks.svg	pass	122871	21918	100953	0
svgs/oxygen-icons-5.113.0/scalable/actions/small/16x16/view-presentation.svg	pass	90869	9810	81059	0
svgs/oxygen-icons-5.113.0/scalable/actions/small/16x16/view-preview.svg	pass	113152	38170	74982	0
svgs/oxygen-icons-5.113.0/scalable/actions/small/16x16/view-process-all-tree.svg	pass	18124	4050	14074	0
svgs/oxygen-icons-5.113.0/scalable/actions/small/16x16/view-process-all.svg	pass	17127	3205	13922	0
svgs/oxygen-icons-5.113.0/scalable/actions/small/16x16/view-process-own.svg	pass	95088	4745	90343	0
svgs/oxygen-icons-5.113.0/scalable/actions/small/16x16/view-process-system.svg	pass	19714	4479	15235	0
svgs/oxygen-icons-5.113.0/scalable/actions/small/16x16/view-process-users.svg	pass	22762	5901	16861	0
svgs/oxygen-icons-5.113.0/scalable/actions/small/16x16/view-refresh.svg	pass	60613	17751	42862	0
svgs/oxygen-icons-5.113.0/scalable/actions/small/16x16/view-resource-calendar.svg	pass	186911	36280	150631	0
svgs/oxygen-icons-5.113.0/scalable/actions/small/16x16/view-restore.svg	pass	291118	2270	288848	0
svgs/oxygen-icons-5.113.0/scalable/actions/small/16x16/view-right-close.svg	pass	77447	6261	71186	0
svgs/oxygen-icons-5.113.0/scalable/actions/small/16x16/view-right-new.svg	pass	77837	6493	71344	0
svgs/oxygen-icons-5.113.0/scalable/actions/small/16x16/view-sort-ascending.svg	pass	16849	6235	10614	0
svgs/oxygen-icons-5.113.0/scalable/actions/small/16x16/view-sort-descending.svg	pass	15693	6265	9428	0
svgs/oxygen-icons-5.113.0/scalable/actions/small/16x16/view-split-left-right.svg	pass	76181	5426	70755	0
svgs/oxygen-icons-5.113.0/scalable/actions/small/16x16/view-split-top-bottom.svg	pass	76174	5429	70745	0
svgs/oxygen-icons-5.113.0/scalable/actions/small/16x16/view-task-add.svg	pass	186091	21051	165040	0
svgs/oxygen-icons-5.113.0/scalable/actions/small/16x16/view-task-child-add.svg	pass	92290	12922	79368	0
svgs/oxygen-icons-5.113.0/scalable/actions/small/16x16/view-task-child.svg	pass	84394	9452	74942	0
svgs/oxygen-icons-5.113.0/scalable/actions/small/16x16/view-task.svg	pass	92051	17196	74855	0
svgs/oxygen-icons-5.113.0/scalable/actions/small/16x16/view-time-schedule-baselined-add.svg	pass	183677	13732	169945	0
svgs/oxygen-icons-5.113.0/scalable/actions/small/16x16/view-time-schedule-baselined-remove.svg	pass	207035	13287	193748	0
svgs/oxygen-icons-5.113.0/scalable/actions/small/16x16/view-time-schedule-baselined.svg	pass	158648	8831	149817	0
svgs/oxygen-icons-5.113.0/scalable/actions/small/16x16/view-time-schedule-calculus.svg	mismatch	75822	26486	49336	6
svgs/oxygen-icons-5.113.0/scalable/actions/small/16x16/view-time-schedule-child-insert.svg	pass	46871	9075	37796	0
svgs/oxygen-icons-5.113.0/scalable/actions/small/16x16/view-time-schedule-edit.svg	pass	72255	14705	57550	0
svgs/oxygen-icons-5.113.0/scalable/actions/small/16x16/view-time-schedule-insert.svg	pass	53734	7951	45783	0
svgs/oxygen-icons-5.113.0/scalable/actions/small/16x16/view-time-schedule.svg	pass	46295	4481	41814	0
svgs/oxygen-icons-5.113.0/scalable/actions/small/16x16/window-duplicate.svg	pass	82027	5925	76102	0
svgs/oxygen-icons-5.113.0/scalable/actions/small/16x16/window-new.svg	pass	83937	8561	75376	0
svgs/oxygen-icons-5.113.0/scalable/actions/small/16x16/zoom-1-to-2.svg	mismatch	105239	12620	92619	8
svgs/oxygen-icons-5.113.0/scalable/actions/small/16x16/zoom-2-to-1.svg	mismatch	105757	12896	92861	8
svgs/oxygen-icons-5.113.0/scalable/actions/small/16x16/zoom-draw.svg	mismatch	194877	13681	181196	15
svgs/oxygen-icons-5.113.0/scalable/actions/small/16x16/zoom-fit-best.svg	pass	36405	6091	30314	0
svgs/oxygen-icons-5.113.0/scalable/actions/small/16x16/zoom-fit-height.svg	pass	36939	6100	30839	0
svgs/oxygen-icons-5.113.0/scalable/actions/small/16x16/zoom-fit-width.svg	pass	37816	6082	31734	0
svgs/oxygen-icons-5.113.0/scalable/actions/small/16x16/zoom-in.svg	mismatch	104209	13557	90652	8
svgs/oxygen-icons-5.113.0/scalable/actions/small/16x16/zoom-next.svg	mismatch	101764	12301	89463	6
svgs/oxygen-icons-5.113.0/scalable/actions/small/16x16/zoom-original.svg	mismatch	103135	11675	91460	7
svgs/oxygen-icons-5.113.0/scalable/actions/small/16x16/zoom-out.svg	mismatch	103445	13202	90243	6
svgs/oxygen-icons-5.113.0/scalable/actions/small/16x16/zoom-previous.svg	mismatch	103988	12305	91683	6
svgs/oxygen-icons-5.113.0/scalable/actions/small/16x16/zoom-select.svg	mismatch	32453	13240	19213	11
svgs/oxygen-icons-5.113.0/scalable/actions/small/22x22/acrobat.svg	pass	9169	3951	5218	0
svgs/oxygen-icons-5.113.0/scalable/actions/small/22x22/address-book-new.svg	pass	3641288	2332734	1308554	0
svgs/oxygen-icons-5.113.0/scalable/actions/small/22x22/align-horizontal-center.svg	pass	9264	4093	5171	0
svgs/oxygen-icons-5.113.0/scalable/actions/small/22x22/align-horizontal-left-out.svg	pass	12301	5774	6527	0
svgs/oxygen-icons-5.113.0/scalable/actions/small/22x22/align-horizontal-left.svg	pass	9269	4112	5157	0
svgs/oxygen-icons-5.113.0/scalable/actions/small/22x22/align-horizontal-right-out.svg	pass	12269	5740	6529	0
svgs/oxygen-icons-5.113.0/scalable/actions/small/22x22/align-horizontal-right.svg	pass	9272	4108	5164	0
svgs/oxygen-icons-5.113.0/scalable/actions/small/22x22/align-vertical-bottom-out.svg	pass	12562	6016	6546	0
svgs/oxygen-icons-5.113.0/scalable/actions/small/22x22/align-vertical-bottom.svg	pass	9506	4281	5225	0
svgs/oxygen-icons-5.113.0/scalable/actions/small/22x22/align-vertical-center.svg	pass	9914	4588	5326	0
svgs/oxygen-icons-5.113.0/scalable/actions/small/22x22/align-vertical-top-out.svg	pass	12561	6001	6560	0
svgs/oxygen-icons-5.113.0/scalable/actions/small/22x22/align-vertical-top.png.svg	pass	9504	4281	5223	0
svgs/oxygen-icons-5.113.0/scalable/actions/small/22x22/application-exit.svg	pass	36507	12772	23735	0
svgs/oxygen-icons-5.113.0/scalable/actions/small/22x22/appointment-new.svg	pass	79345	36875	42470	0
svgs/oxygen-icons-5.113.0/scalable/actions/small/22x22/archive-extract.svg	pass	33810	9335	24475	0
svgs/oxygen-icons-5.113.0/scalable/actions/small/22x22/archive-insert-directory.svg	pass	1561659	126423	1435236	0
svgs/oxygen-icons-5.113.0/scalable/actions/small/22x22/archive-insert.svg	pass	31574	16505	15069	0
svgs/oxygen-icons-5.113.0/scalable/actions/small/22x22/archive-remove.svg	pass	172302	10910	161392	0
svgs/oxygen-icons-5.113.0/scalable/actions/small/22x22/arrow-down-double.svg	pass	39410	10709	28701	0
svgs/oxygen-icons-5.113.0/scalable/actions/small/22x22/arrow-left-double.svg	pass	39390	10661	28729	0
svgs/oxygen-icons-5.113.0/scalable/actions/small/22x22/arrow-right-double.svg	pass	39406	10720	28686	0
svgs/oxygen-icons-5.113.0/scalable/actions/small/22x22/arrow-up-double.svg	pass	39406	10682	28724	0
svgs/oxygen-icons-5.113.0/scalable/actions/small/22x22/bookmark-new-list.svg	pass	126460	52698	73762	0
svgs/oxygen-icons-5.113.0/scalable/actions/small/22x22/bookmark-new.svg	pass	39614	10038	29576	0
svgs/oxygen-icons-5.113.0/scalable/actions/small/22x22/bookmark-toolbar.svg	pass	219085	20600	198485	0
svgs/oxygen-icons-5.113.0/scalable/actions/small/22x22/bookmarks-organize.svg	pass	957602	503564	454038	0
svgs/oxygen-icons-5.113.0/scalable/actions/small/22x22/call-start.svg	pass	43845	7978	35867	0
svgs/oxygen-icons-5.113.0/scalable/actions/small/22x22/call-stop.svg	pass	60545	7743	52802	0
svgs/oxygen-icons-5.113.0/scalable/actions/small/22x22/character-set.svg	pass	9443	3867	5576	0
svgs/oxygen-icons-5.113.0/scalable/actions/small/22x22/checkbox.svg	pass	45311	11943	33368	0
svgs/oxygen-icons-5.113.0/scalable/actions/small/22x22/code-block.svg	pass	46809	10975	35834	0
svgs/oxygen-icons-5.113.0/scalable/actions/small/22x22/code-class.svg	pass	47681	12458	35223	0
svgs/oxygen-icons-5.113.0/scalable/actions/small/22x22/code-context.svg	pass	146672	7396	139276	0
svgs/oxygen-icons-5.113.0/scalable/actions/small/22x22/code-function.svg	pass	36220	6299	29921	0
svgs/oxygen-icons-5.113.0/scalable/actions/small/22x22/code-typedef.svg	pass	23398	5982	17416	2
svgs/oxygen-icons-5.113.0/scalable/actions/small/22x22/code-variable.svg	pass	38680	5396	33284	0
svgs/oxygen-icons-5.113.0/scalable/actions/small/22x22/color-picker-black.svg	pass	49195	19616	29579	0
svgs/oxygen-icons-5.113.0/scalable/actions/small/22x22/color-picker-grey.svg	pass	48316	19294	29022	0
svgs/oxygen-icons-5.113.0/scalable/actions/small/22x22/color-picker-white.svg	pass	48306	19286	29020	0
svgs/oxygen-icons-5.113.0/scalable/actions/small/22x22/color-picker.svg	pass	40950	16080	24870	0
svgs/oxygen-icons-5.113.0/scalable/actions/small/22x22/configure-toolbars.svg	pass	227189	31286	195903	0
svgs/oxygen-icons-5.113.0/scalable/actions/small/22x22/configure.svg	pass	175657	30413	145244	0
svgs/oxygen-icons-5.113.0/scalable/actions/small/22x22/contact-new.svg	pass	114133	50175	63958	0
svgs/oxygen-icons-5.113.0/scalable/actions/small/22x22/debug-execute-from-cursor.svg	pass	151490	5869	145621	0
svgs/oxygen-icons-5.113.0/scalable/actions/small/22x22/debug-execute-to-cursor.svg	pass	150700	5850	144850	0
svgs/oxygen-icons-5.113.0/scalable/actions/small/22x22/debug-run-cursor.svg	pass	422401	42902	379499	0
svgs/oxygen-icons-5.113.0/scalable/actions/small/22x22/debug-run.svg	pass	421178	41271	379907	0
svgs/oxygen-icons-5.113.0/scalable/actions/small/22x22/debug-step-instruction.svg	pass	124311	9189	115122	0
svgs/oxygen-icons-5.113.0/scalable/actions/small/22x22/debug-step-into-instruction.svg	pass	125490	9807	115683	0
svgs/oxygen-icons-5.113.0/scalable/actions/small/22x22/debug-step-into.svg	pass	125092	9661	115431	0
svgs/oxygen-icons-5.113.0/scalable/actions/small/22x22/debug-step-out.svg	pass	122257	8862	113395	0
svgs/oxygen-icons-5.113.0/scalable/actions/small/22x22/debug-step-over.svg	pass	123952	9053	114899	0
svgs/oxygen-icons-5.113.0/scalable/actions/small/22x22/dialog-cancel.svg	pass	4799	1637	3162	0
svgs/oxygen-icons-5.113.0/scalable/actions/small/22x22/dialog-ok-apply.svg	pass	18285	9068	9217	0
svgs/oxygen-icons-5.113.0/scalable/actions/small/22x22/dialog-ok.svg	pass	20655	9241	11414	0
svgs/oxygen-icons-5.113.0/scalable/actions/small/22x22/distribute-horizontal-center.svg	pass	51234	4671	46563	0
svgs/oxygen-icons-5.113.0/scalable/actions/small/22x22/distribute-horizontal-equal.svg	pass	51245	4677	46568	0
svgs/oxygen-icons-5.113.0/scalable/actions/small/22x22/distribute-horizontal-left.svg	pass	51255	4662	46593	0
svgs/oxygen-icons-5.113.0/scalable/actions/small/22x22/distribute-horizontal-margin.svg	pass	10210	3637	6573	0
svgs/oxygen-icons-5.113.0/scalable/actions/small/22x22/distribute-horizontal-page.svg	pass	19805	8490	11315	0
svgs/oxygen-icons-5.113.0/scalable/actions/small/22x22/distribute-horizontal-right.svg	pass	51232	4661	46571	0
svgs/oxygen-icons-5.113.0/scalable/actions/small/22x22/distribute-horizontal-x.svg	pass	9460	3718	5742	0
svgs/oxygen-icons-5.113.0/scalable/actions/small/22x22/distribute-vertical-bottom.svg	pass	51837	4877	46960	0
svgs/oxygen-icons-5.113.0/scalable/actions/small/22x22/distribute-vertical-center.svg	pass	11472	5553	5919	0
svgs/oxygen-icons-5.113.0/scalable/actions/small/22x22/distribute-vertical-equal.svg	pass	10001	4592	5409	0
svgs/oxygen-icons-5.113.0/scalable/actions/small/22x22/distribute-vertical-margin.svg	pass	9188	3618	5570	0
svgs/oxygen-icons-5.113.0/scalable/actions/small/22x22/distribute-vertical-page.svg	pass	29359	8509	20850	0
svgs/oxygen-icons-5.113.0/scalable/actions/small/22x22/distribute-vertical-top.svg	pass	51487	4872	46615	0
svgs/oxygen-icons-5.113.0/scalable/actions/small/22x22/distribute-vertical-y.svg	pass	11562	3810	7752	0
svgs/oxygen-icons-5.113.0/scalable/actions/small/22x22/document-decrypt.svg	pass	259582	169206	90376	0
svgs/oxygen-icons-5.113.0/scalable/actions/small/22x22/document-edit-decrypt-verify.svg	pass	133802	64614	69188	0
svgs/oxygen-icons-5.113.0/scalable/actions/small/22x22/document-edit-decrypt.svg	pass	121484	54011	67473	0
svgs/oxygen-icons-5.113.0/scalable/actions/small/22x22/document-edit-emcrypted.svg	pass	47020	10726	36294	0
svgs/oxygen-icons-5.113.0/scalable/actions/small/22x22/document-edit-encrypt.svg	pass	90232	41349	48883	0
svgs/oxygen-icons-5.113.0/scalable/actions/small/22x22/document-edit-sign-encrypt.svg	pass	113421	58693	54728	1
svgs/oxygen-icons-5.113.0/scalable/actions/small/22x22/document-edit-sign.svg	pass	172264	98939	73325	0
svgs/oxygen-icons-5.113.0/scalable/actions/small/22x22/document-edit-verify.svg	pass	203302	129576	73726	0
svgs/oxygen-icons-5.113.0/scalable/actions/small/22x22/document-edit.svg	pass	67288	17702	49586	0
svgs/oxygen-icons-5.113.0/scalable/actions/small/22x22/document-encrypt.svg	pass	263401	170174	93227	0
svgs/oxygen-icons-5.113.0/scalable/actions/small/22x22/document-export-table.svg	pass	149974	15455	134519	0
svgs/oxygen-icons-5.113.0/scalable/actions/small/22x22/document-export.svg	pass	32859	9077	23782	0
svgs/oxygen-icons-5.113.0/scalable/actions/small/22x22/document-import.svg	pass	32599	9448	23151	0
svgs/oxygen-icons-5.113.0/scalable/actions/small/22x22/document-new.svg	pass	17815	6588	11227	0
svgs/oxygen-icons-5.113.0/scalable/actions/small/22x22/document-open-folder.svg	pass	129652	116831	12821	0
svgs/oxygen-icons-5.113.0/scalable/actions/small/22x22/document-open-remote.svg	pass	800174	452338	347836	0
svgs/oxygen-icons-5.113.0/scalable/actions/small/22x22/document-open.svg	pass	144568	124579	19989	0
svgs/oxygen-icons-5.113.0/scalable/actions/small/22x22/document-preview-archive.svg	pass	658397	28965	629432	0
svgs/oxygen-icons-5.113.0/scalable/actions/small/22x22/document-preview.svg	pass	147014	25543	121471	0
svgs/oxygen-icons-5.113.0/scalable/actions/small/22x22/document-print-direct.svg	pass	78130	31380	46750	1
svgs/oxygen-icons-5.113.0/scalable/actions/small/22x22/document-print-frame.svg	pass	371576	23467	348109	0
svgs/oxygen-icons-5.113.0/scalable/actions/small/22x22/document-print-preview.svg	pass	75468	34042	41426	0
svgs/oxygen-icons-5.113.0/scalable/actions/small/22x22/document-print.svg	pass	365669	21821	343848	0
svgs/oxygen-icons-5.113.0/scalable/actions/small/22x22/document-properties.svg	pass	36178	18067	18111	1
svgs/oxygen-icons-5.113.0/scalable/actions/small/22x22/document-revert.svg	pass	46778	20304	26474	0
svgs/oxygen-icons-5.113.0/scalable/actions/small/22x22/document-save-all.svg	pass	548562	31830	516732	0
svgs/oxygen-icons-5.113.0/scalable/actions/small/22x22/document-save-as.svg	pass	50281	30206	20075	0
svgs/oxygen-icons-5.113.0/scalable/actions/small/22x22/document-save.svg	pass	519083	18230	500853	0
svgs/oxygen-icons-5.113.0/scalable/actions/small/22x22/documentation.svg	pass	24134	10259	13875	0
svgs/oxygen-icons-5.113.0/scalable/actions/small/22x22/download-later.svg	pass	95696	17825	77871	0
svgs/oxygen-icons-5.113.0/scalable/actions/small/22x22/download.svg	pass	667375	346449	320926	0
svgs/oxygen-icons-5.113.0/scalable/actions/small/22x22/draw-arrow-back.svg	pass	8002	2455	5547	0
svgs/oxygen-icons-5.113.0/scalable/actions/small/22x22/draw-arrow-down.svg	pass	7482	2588	4894	0
svgs/oxygen-icons-5.113.0/scalable/actions/small/22x22/draw-arrow-forward.svg	pass	9049	2468	6581	0
svgs/oxygen-icons-5.113.0/scalable/actions/small/22x22/draw-arrow-up.svg	pass	8407	2490	5917	0
svgs/oxygen-icons-5.113.0/scalable/actions/small/22x22/draw-bezier-curves.svg	pass	21124	4952	16172	0
svgs/oxygen-icons-5.113.0/scalable/actions/small/22x22/draw-brush.svg	pass	37758	14312	23446	0
svgs/oxygen-icons-5.113.0/scalable/actions/small/22x22/draw-circle.svg	pass	6101	2293	3808	0
svgs/oxygen-icons-5.113.0/scalable/actions/small/22x22/draw-cross.svg	pass	7040	2823	4217	0
svgs/oxygen-icons-5.113.0/scalable/actions/small/22x22/draw-donut.svg	pass	7325	2640	4685	0
svgs/oxygen-icons-5.113.0/scalable/actions/small/22x22/draw-ellipse.svg	pass	6179	1983	4196	0
svgs/oxygen-icons-5.113.0/scalable/actions/small/22x22/draw-eraser.svg	pass	98337	14894	83443	0
svgs/oxygen-icons-5.113.0/scalable/actions/small/22x22/draw-freehand.svg	pass	32393	14166	18227	1
svgs/oxygen-icons-5.113.0/scalable/actions/small/22x22/draw-halfcircle2.svg	pass	6025	1881	4144	0
svgs/oxygen-icons-5.113.0/scalable/actions/small/22x22/draw-halfcircle3.svg	pass	6366	1879	4487	0
svgs/oxygen-icons-5.113.0/scalable/actions/small/22x22/draw-halfcircle4.svg	pass	6843	1834	5009	0
svgs/oxygen-icons-5.113.0/scalable/actions/small/22x22/draw-path.svg	pass	39662	10304	29358	0
svgs/oxygen-icons-5.113.0/scalable/actions/small/22x22/draw-polygon.svg	pass	6074	1881	4193	0
svgs/oxygen-icons-5.113.0/scalable/actions/small/22x22/draw-polyline.svg	pass	36703	2107	34596	0
svgs/oxygen-icons-5.113.0/scalable/actions/small/22x22/draw-rectangle.svg	pass	35234	1918	33316	0
svgs/oxygen-icons-5.113.0/scalable/actions/small/22x22/draw-spiral.svg	pass	19186	3252	15934	0
svgs/oxygen-icons-5.113.0/scalable/actions/small/22x22/draw-square-inverted-corners.svg	pass	6111	2072	4039	0
svgs/oxygen-icons-5.113.0/scalable/actions/small/22x22/draw-star.svg	pass	5905	1972	3933	0
svgs/oxygen-icons-5.113.0/scalable/actions/small/22x22/draw-text.svg	pass	8551	1369	7182	0
svgs/oxygen-icons-5.113.0/scalable/actions/small/22x22/draw-triangle.svg	pass	5915	1896	4019	0
svgs/oxygen-icons-5.113.0/scalable/actions/small/22x22/draw-triangle1.svg	pass	35114	1949	33165	0
svgs/oxygen-icons-5.113.0/scalable/actions/small/22x22/draw-triangle2.svg	pass	5916	1901	4015	0
svgs/oxygen-icons-5.113.0/scalable/actions/small/22x22/draw-triangle3.svg	pass	5865	1875	3990	0
svgs/oxygen-icons-5.113.0/scalable/actions/small/22x22/draw-triangle4.svg	pass	6425	1914	4511	0
svgs/oxygen-icons-5.113.0/scalable/actions/small/22x22/edit-clear-history.svg	pass	53636	22561	31075	0
svgs/oxygen-icons-5.113.0/scalable/actions/small/22x22/edit-clear-list.svg	pass	204058	14620	189438	0
svgs/oxygen-icons-5.113.0/scalable/actions/small/22x22/edit-clear-locationbar-rtl.svg	pass	90795	7594	83201	0
svgs/oxygen-icons-5.113.0/scalable/actions/small/22x22/edit-clear.svg	pass	35380	2706	32674	0
svgs/oxygen-icons-5.113.0/scalable/actions/small/22x22/edit-copy.svg	pass	33215	4668	28547	0
svgs/oxygen-icons-5.113.0/scalable/actions/small/22x22/edit-cut.svg	pass	29722	3708	26014	0
svgs/oxygen-icons-5.113.0/scalable/actions/small/22x22/edit-delete.svg	pass	176871	5849	171022	0
svgs/oxygen-icons-5.113.0/scalable/actions/small/22x22/edit-find-mail.svg	pass	122708	22067	100641	0
svgs/oxygen-icons-5.113.0/scalable/actions/small/22x22/edit-find-project.svg	pass	169175	18162	151013	0
svgs/oxygen-icons-5.113.0/scalable/actions/small/22x22/edit-find-replace.svg	pass	157773	29658	128115	0
svgs/oxygen-icons-5.113.0/scalable/actions/small/22x22/edit-find.svg	pass	91456	16972	74484	0
svgs/oxygen-icons-5.113.0/scalable/actions/small/22x22/edit-guides.svg	pass	20019	4285	15734	0
svgs/oxygen-icons-5.113.0/scalable/actions/small/22x22/edit-image-face-add.svg	mismatch	761819	51441	710378	22
svgs/oxygen-icons-5.113.0/scalable/actions/small/22x22/edit-image-face-detect.svg	pass	17662	3392	14270	0
svgs/oxygen-icons-5.113.0/scalable/actions/small/22x22/edit-image-face-recognize.svg	mismatch	179953	46270	133683	6
svgs/oxygen-icons-5.113.0/scalable/actions/small/22x22/edit-image-face-show.svg	pass	173505	42710	130795	0
svgs/oxygen-icons-5.113.0/scalable/actions/small/22x22/edit-node.svg	pass	9649	4054	5595	0
svgs/oxygen-icons-5.113.0/scalable/actions/small/22x22/edit-paste.svg	pass	86598	14183	72415	0
svgs/oxygen-icons-5.113.0/scalable/actions/small/22x22/edit-redo.svg	pass	40380	20322	20058	0
svgs/oxygen-icons-5.113.0/scalable/actions/small/22x22/edit-rename.svg	pass	35380	2706	32674	0
svgs/oxygen-icons-5.113.0/scalable/actions/small/22x22/edit-select-all.svg	pass	216219	110467	105752	0
svgs/oxygen-icons-5.113.0/scalable/actions/small/22x22/edit-select-none.svg	mismatch	258721	126661	132060	8
svgs/oxygen-icons-5.113.0/scalable/actions/small/22x22/edit-select.svg	pass	25200	2718	22482	0
svgs/oxygen-icons-5.113.0/scalable/actions/small/22x22/edit-table-cell-merge.svg	pass	291442	5527	285915	0
svgs/oxygen-icons-5.113.0/scalable/actions/small/22x22/edit-table-cell-split.svg	pass	284607	5153	279454	0
svgs/oxygen-icons-5.113.0/scalable/actions/small/22x22/edit-table-delete-row.svg	pass	773969	19872	754097	2
svgs/oxygen-icons-5.113.0/scalable/actions/small/22x22/edit-table-insert-column-left.svg	pass	602285	15168	587117	0
svgs/oxygen-icons-5.113.0/scalable/actions/small/22x22/edit-table-insert-column-right.svg	pass	596216	15044	581172	0
svgs/oxygen-icons-5.113.0/scalable/actions/small/22x22/edit-table-insert-row-above.svg	pass	1189170	18809	1170361	1
svgs/oxygen-icons-5.113.0/scalable/actions/small/22x22/edit-table-insert-row-under.svg	pass	568052	14973	553079	0
svgs/oxygen-icons-5.113.0/scalable/actions/small/22x22/edit-text-frame-update.svg	pass	11280	4041	7239	0
svgs/oxygen-icons-5.113.0/scalable/actions/small/22x22/edit-undo.svg	pass	39545	19147	20398	0
svgs/oxygen-icons-5.113.0/scalable/actions/small/22x22/folder-new.svg	pass	1561633	126423	1435210	0
svgs/oxygen-icons-5.113.0/scalable/actions/small/22x22/folder-sync.svg	pass	260200	227310	32890	0
svgs/oxygen-icons-5.113.0/scalable/actions/small/22x22/format-add-node.svg	pass	26900	13117	13783	0
svgs/oxygen-icons-5.113.0/scalable/actions/small/22x22/format-break-node.svg	pass	16176	5782	10394	0
svgs/oxygen-icons-5.113.0/scalable/actions/small/22x22/format-connect-node.svg	pass	18762	7342	11420	0
svgs/oxygen-icons-5.113.0/scalable/actions/small/22x22/format-disconnect-node.svg	pass	17553	7062	10491	0
svgs/oxygen-icons-5.113.0/scalable/actions/small/22x22/format-join-node.svg	pass	14565	5797	8768	0
svgs/oxygen-icons-5.113.0/scalable/actions/small/22x22/format-remove-node.svg	pass	31890	12256	19634	0
svgs/oxygen-icons-5.113.0/scalable/actions/small/22x22/format-text-color.svg	pass	92142	3974	88168	0
svgs/oxygen-icons-5.113.0/scalable/actions/small/22x22/games-highscores.svg	pass	291822	144429	147393	0
svgs/oxygen-icons-5.113.0/scalable/actions/small/22x22/go-down-search.svg	pass	70309	7922	62387	0
svgs/oxygen-icons-5.113.0/scalable/actions/small/22x22/go-down.svg	pass	29625	8722	20903	0
svgs/oxygen-icons-5.113.0/scalable/actions/small/22x22/go-first-view-page.svg	pass	43492	23615	19877	0
svgs/oxygen-icons-5.113.0/scalable/actions/small/22x22/go-first-view.svg	pass	18291	9598	8693	0
svgs/oxygen-icons-5.113.0/scalable/actions/small/22x22/go-home.svg	pass	35366	16382	18984	0
svgs/oxygen-icons-5.113.0/scalable/actions/small/22x22/go-jump-declaration.svg	pass	65414	14184	51230	0
svgs/oxygen-icons-5.113.0/scalable/actions/small/22x22/go-jump-definition.svg	pass	125906	8826	117080	0
svgs/oxygen-icons-5.113.0/scalable/actions/small/22x22/go-jump-locationbar.svg	pass	752862	337986	414876	0
svgs/oxygen-icons-5.113.0/scalable/actions/small/22x22/go-jump-today.svg	pass	104752	38189	66563	0
svgs/oxygen-icons-5.113.0/scalable/actions/small/22x22/go-last-view-page.svg	pass	264420	23899	240521	0
svgs/oxygen-icons-5.113.0/scalable/actions/small/22x22/go-last-view.svg	pass	23838	9779	14059	0
svgs/oxygen-icons-5.113.0/scalable/actions/small/22x22/go-next-context.svg	pass	18003	7460	10543	0
svgs/oxygen-icons-5.113.0/scalable/actions/small/22x22/go-next-use.svg	pass	122801	8749	114052	0
svgs/oxygen-icons-5.113.0/scalable/actions/small/22x22/go-next-view-page.svg	pass	115551	16290	99261	0
svgs/oxygen-icons-5.113.0/scalable/actions/small/22x22/go-next-view.svg	pass	4431	2613	1818	0
svgs/oxygen-icons-5.113.0/scalable/actions/small/22x22/go-next.svg	pass	30417	10596	19821	0
svgs/oxygen-icons-5.113.0/scalable/actions/small/22x22/go-previous-context.svg	pass	16610	7334	9276	0
svgs/oxygen-icons-5.113.0/scalable/actions/small/22x22/go-previous-use.svg	pass	130224	8727	121497	0
svgs/oxygen-icons-5.113.0/scalable/actions/small/22x22/go-previous-view-page.svg	pass	115553	16251	99302	0
svgs/oxygen-icons-5.113.0/scalable/actions/small/22x22/go-previous-view.svg	pass	4590	2678	1912	0
svgs/oxygen-icons-5.113.0/scalable/actions/small/22x22/go-previous.svg	pass	22093	7863	14230	0
svgs/oxygen-icons-5.113.0/scalable/actions/small/22x22/go-up-search.svg	pass	69538	7881	61657	0
svgs/oxygen-icons-5.113.0/scalable/actions/small/22x22/go-up.svg	pass	26837	8239	18598	0
svgs/oxygen-icons-5.113.0/scalable/actions/small/22x22/help-about.svg	pass	44615	11368	33247	2
svgs/oxygen-icons-5.113.0/scalable/actions/small/22x22/help-contents.svg	pass	1347272	683095	664177	0
svgs/oxygen-icons-5.113.0/scalable/actions/small/22x22/help-donate.svg	pass	145006	13624	131382	0
svgs/oxygen-icons-5.113.0/scalable/actions/small/22x22/help-feedback.svg	pass	56183	16595	39588	2
svgs/oxygen-icons-5.113.0/scalable/actions/small/22x22/im-aim.svg	pass	33328	14528	18800	0
svgs/oxygen-icons-5.113.0/scalable/actions/small/22x22/im-facebook.svg	pass	9942	3971	5971	0
svgs/oxygen-icons-5.113.0/scalable/actions/small/22x22/im-gadugadu.svg	pass	27261	10870	16391	0
svgs/oxygen-icons-5.113.0/scalable/actions/small/22x22/im-google-talk.svg	pass	15583	7574	8009	0
svgs/oxygen-icons-5.113.0/scalable/actions/small/22x22/im-google.svg	mismatch	26530	12209	14321	29
svgs/oxygen-icons-5.113.0/scalable/actions/small/22x22/im-icq.svg	pass	70098	25834	44264	0
svgs/oxygen-icons-5.113.0/scalable/actions/small/22x22/im-identi.ca.svg	pass	35112	23516	11596	0
svgs/oxygen-icons-5.113.0/scalable/actions/small/22x22/im-jabber.svg	pass	53970	17084	36886	0
svgs/oxygen-icons-5.113.0/scalable/actions/small/22x22/im-msn.svg	pass	78642	26004	52638	0
svgs/oxygen-icons-5.113.0/scalable/actions/small/22x22/im-qq.svg	pass	55161	20447	34714	0
svgs/oxygen-icons-5.113.0/scalable/actions/small/22x22/im-skype.svg	pass	43845	7978	35867	0
svgs/oxygen-icons-5.113.0/scalable/actions/small/22x22/im-twitter.svg	pass	14236	5297	8939	0
svgs/oxygen-icons-5.113.0/scalable/actions/small/22x22/im-yahoo.svg	pass	56967	22946	34021	0
svgs/oxygen-icons-5.113.0/scalable/actions/small/22x22/insert-horizontal-rule.svg	pass	219408	13820	205588	0
svgs/oxygen-icons-5.113.0/scalable/actions/small/22x22/insert-image.svg	pass	932449	557765	374684	0
svgs/oxygen-icons-5.113.0/scalable/actions/small/22x22/insert-link.svg	pass	191750	16826	174924	0
svgs/oxygen-icons-5.113.0/scalable/actions/small/22x22/insert-table.svg	pass	31948	11225	20723	0
svgs/oxygen-icons-5.113.0/scalable/actions/small/22x22/insert-text.svg	pass	45010	9295	35715	0
svgs/oxygen-icons-5.113.0/scalable/actions/small/22x22/irc-close-channel.svg	mismatch	83618	35037	48581	7
svgs/oxygen-icons-5.113.0/scalable/actions/small/22x22/irc-join-channel.svg	pass	272320	32663	239657	0
svgs/oxygen-icons-5.113.0/scalable/actions/small/22x22/key-enter.svg	pass	140422	4156	136266	0
svgs/oxygen-icons-5.113.0/scalable/actions/small/22x22/list-add-font.svg	pass	230467	16395	214072	0
svgs/oxygen-icons-5.113.0/scalable/actions/small/22x22/list-add-user.svg	mismatch	193786	54342	139444	23
svgs/oxygen-icons-5.113.0/scalable/actions/small/22x22/list-add.svg	pass	21628	10496	11132	0
svgs/oxygen-icons-5.113.0/scalable/actions/small/22x22/list-remove.svg	pass	14909	6421	8488	0
svgs/oxygen-icons-5.113.0/scalable/actions/small/22x22/list-resource-add.svg	pass	359945	148049	211896	1
svgs/oxygen-icons-5.113.0/scalable/actions/small/22x22/mail-encrypted-full.svg	pass	85193	15537	69656	0
svgs/oxygen-icons-5.113.0/scalable/actions/small/22x22/mail-encrypted-part.svg	pass	83492	15869	67623	0
svgs/oxygen-icons-5.113.0/scalable/actions/small/22x22/mail-encrypted.svg	pass	99882	17139	82743	0
svgs/oxygen-icons-5.113.0/scalable/actions/small/22x22/mail-flag.svg	pass	71321	38091	33230	0
svgs/oxygen-icons-5.113.0/scalable/actions/small/22x22/mail-forward.svg	mismatch	126793	8827	117966	18
svgs/oxygen-icons-5.113.0/scalable/actions/small/22x22/mail-forwarded.svg	pass	242386	42148	200238	0
svgs/oxygen-icons-5.113.0/scalable/actions/small/22x22/mail-invitation.svg	pass	146829	12120	134709	0
svgs/oxygen-icons-5.113.0/scalable/actions/small/22x22/mail-mark-important.svg	pass	450353	9852	440501	0
svgs/oxygen-icons-5.113.0/scalable/actions/small/22x22/mail-mark-junk.svg	pass	450456	6204	444252	0
svgs/oxygen-icons-5.113.0/scalable/actions/small/22x22/mail-mark-notjunk.svg	pass	19690	8490	11200	0
svgs/oxygen-icons-5.113.0/scalable/actions/small/22x22/mail-mark-read.svg	pass	123123	37208	85915	0
svgs/oxygen-icons-5.113.0/scalable/actions/small/22x22/mail-mark-task.svg	pass	51604	20414	31190	0
svgs/oxygen-icons-5.113.0/scalable/actions/small/22x22/mail-mark-unread-new.svg	pass	303582	7777	295805	0
svgs/oxygen-icons-5.113.0/scalable/actions/small/22x22/mail-mark-unread.svg	pass	70187	4739	65448	0
svgs/oxygen-icons-5.113.0/scalable/actions/small/22x22/mail-meeting-request-reply.svg	pass	64946	5437	59509	0
svgs/oxygen-icons-5.113.0/scalable/actions/small/22x22/mail-message-new-list.svg	pass	182043	41232	140811	2
svgs/oxygen-icons-5.113.0/scalable/actions/small/22x22/mail-message-new.svg	pass	177921	41222	136699	0
svgs/oxygen-icons-5.113.0/scalable/actions/small/22x22/mail-queue.svg	mismatch	179958	8674	171284	15
svgs/oxygen-icons-5.113.0/scalable/actions/small/22x22/mail-receive.svg	mismatch	137149	12516	124633	11
svgs/oxygen-icons-5.113.0/scalable/actions/small/22x22/mail-replied.svg	pass	312691	42969	269722	0
svgs/oxygen-icons-5.113.0/scalable/actions/small/22x22/mail-reply-all.svg	pass	23404	10625	12779	0
svgs/oxygen-icons-5.113.0/scalable/actions/small/22x22/mail-reply-custom-all.svg	pass	119669	7226	112443	0
svgs/oxygen-icons-5.113.0/scalable/actions/small/22x22/mail-reply-custom.svg	pass	119384	7097	112287	0
svgs/oxygen-icons-5.113.0/scalable/actions/small/22x22/mail-reply-list.svg	pass	90447	16814	73633	0
svgs/oxygen-icons-5.113.0/scalable/actions/small/22x22/mail-reply-sender.svg	pass	75753	10259	65494	0
svgs/oxygen-icons-5.113.0/scalable/actions/small/22x22/mail-send.svg	pass	181179	5813	175366	0
svgs/oxygen-icons-5.113.0/scalable/actions/small/22x22/mail-signature-unknown.svg	pass	29481	13425	16056	0
svgs/oxygen-icons-5.113.0/scalable/actions/small/22x22/mail-signed-full.svg	pass	18033	5858	12175	0
svgs/oxygen-icons-5.113.0/scalable/actions/small/22x22/mail-signed-part.svg	pass	18632	6161	12471	0
svgs/oxygen-icons-5.113.0/scalable/actions/small/22x22/mail-signed-verified.svg	pass	30951	15079	15872	0
svgs/oxygen-icons-5.113.0/scalable/actions/small/22x22/mail-signed.svg	pass	17528	5452	12076	0
svgs/oxygen-icons-5.113.0/scalable/actions/small/22x22/mail-tagged.svg	pass	19930	8031	11899	0
svgs/oxygen-icons-5.113.0/scalable/actions/small/22x22/measure.svg	pass	10862	3894	6968	0
svgs/oxygen-icons-5.113.0/scalable/actions/small/22x22/meeting-participant-no-response.svg	pass	285041	149701	135340	0
svgs/oxygen-icons-5.113.0/scalable/actions/small/22x22/meeting-participant-request-response.svg	pass	341173	149527	191646	0
svgs/oxygen-icons-5.113.0/scalable/actions/small/22x22/milestone.svg	pass	498436	118096	380340	0
svgs/oxygen-icons-5.113.0/scalable/actions/small/22x22/mixer-ac97.svg	pass	151255	125842	25413	0
svgs/oxygen-icons-5.113.0/scalable/actions/small/22x22/mixer-capture-secondary.svg	pass	50011	5038	44973	0
svgs/oxygen-icons-5.113.0/scalable/actions/small/22x22/mixer-capture.svg	pass	49013	5373	43640	0
svgs/oxygen-icons-5.113.0/scalable/actions/small/22x22/mixer-cd.svg	mismatch	143446	13983	129463	170
svgs/oxygen-icons-5.113.0/scalable/actions/small/22x22/mixer-digital.svg	pass	56148	7378	48770	0
svgs/oxygen-icons-5.113.0/scalable/actions/small/22x22/mixer-front.svg	pass	20580	6386	14194	0
svgs/oxygen-icons-5.113.0/scalable/actions/small/22x22/mixer-headset.svg	pass	76815	38440	38375	0
svgs/oxygen-icons-5.113.0/scalable/actions/small/22x22/mixer-lfe.svg	pass	52335	11498	40837	0
svgs/oxygen-icons-5.113.0/scalable/actions/small/22x22/mixer-line.svg	pass	88306	17722	70584	0
svgs/oxygen-icons-5.113.0/scalable/actions/small/22x22/mixer-master.svg	pass	19068	6302	12766	0
svgs/oxygen-icons-5.113.0/scalable/actions/small/22x22/mixer-microphone-boost.svg	pass	56426	14951	41475	0
svgs/oxygen-icons-5.113.0/scalable/actions/small/22x22/mixer-microphone-front-boost.svg	pass	56660	15248	41412	0
svgs/oxygen-icons-5.113.0/scalable/actions/small/22x22/mixer-microphone-front.svg	pass	33150	11399	21751	0
svgs/oxygen-icons-5.113.0/scalable/actions/small/22x22/mixer-microphone.svg	pass	32557	10920	21637	0
svgs/oxygen-icons-5.113.0/scalable/actions/small/22x22/mixer-midi.svg	pass	85128	13727	71401	0
svgs/oxygen-icons-5.113.0/scalable/actions/small/22x22/mixer-pc-speaker.svg	pass	49933	2448	47485	0
svgs/oxygen-icons-5.113.0/scalable/actions/small/22x22/mixer-pcm-default.svg	pass	24737	1912	22825	0
svgs/oxygen-icons-5.113.0/scalable/actions/small/22x22/mixer-pcm.svg	pass	24692	2032	22660	0
svgs/oxygen-icons-5.113.0/scalable/actions/small/22x22/mixer-surround-center.svg	pass	28968	6322	22646	0
svgs/oxygen-icons-5.113.0/scalable/actions/small/22x22/mixer-surround.svg	pass	25531	4183	21348	0
svgs/oxygen-icons-5.113.0/scalable/actions/small/22x22/mixer-video.svg	pass	59929	11372	48557	0
svgs/oxygen-icons-5.113.0/scalable/actions/small/22x22/network-connect.svg	pass	72105	20868	51237	0
svgs/oxygen-icons-5.113.0/scalable/actions/small/22x22/news-subscribe.svg	pass	432617	17392	415225	0
svgs/oxygen-icons-5.113.0/scalable/actions/small/22x22/news-unsubscribe.svg	mismatch	308976	24896	284080	9
svgs/oxygen-icons-5.113.0/scalable/actions/small/22x22/object-flip-horizontal.svg	pass	73024	7660	65364	0
svgs/oxygen-icons-5.113.0/scalable/actions/small/22x22/object-flip-vertical.svg	pass	73117	7002	66115	0
svgs/oxygen-icons-5.113.0/scalable/actions/small/22x22/office-chart-area-focus-peak-node.svg	pass	22359	6323	16036	0
svgs/oxygen-icons-5.113.0/scalable/actions/small/22x22/office-chart-area-percentage.svg	pass	24502	7084	17418	0
svgs/oxygen-icons-5.113.0/scalable/actions/small/22x22/office-chart-area-stacked.svg	pass	13612	6097	7515	0
svgs/oxygen-icons-5.113.0/scalable/actions/small/22x22/office-chart-area.svg	pass	10307	4988	5319	0
svgs/oxygen-icons-5.113.0/scalable/actions/small/22x22/office-chart-bar-percentage.svg	pass	41744	13547	28197	0
svgs/oxygen-icons-5.113.0/scalable/actions/small/22x22/office-chart-bar-stacked.svg	pass	27831	12295	15536	0
svgs/oxygen-icons-5.113.0/scalable/actions/small/22x22/office-chart-bar.svg	pass	203456	7377	196079	0
svgs/oxygen-icons-5.113.0/scalable/actions/small/22x22/office-chart-line-percentage.svg	pass	19150	5482	13668	0
svgs/oxygen-icons-5.113.0/scalable/actions/small/22x22/office-chart-line-stacked.svg	pass	7627	3679	3948	0
svgs/oxygen-icons-5.113.0/scalable/actions/small/22x22/office-chart-line.svg	pass	200762	3681	197081	0
svgs/oxygen-icons-5.113.0/scalable/actions/small/22x22/office-chart-pie.svg	pass	136878	18197	118681	0
svgs/oxygen-icons-5.113.0/scalable/actions/small/22x22/office-chart-polar-stacked.svg	pass	75053	5177	69876	0
svgs/oxygen-icons-5.113.0/scalable/actions/small/22x22/office-chart-polar.svg	pass	69884	3249	66635	0
svgs/oxygen-icons-5.113.0/scalable/actions/small/22x22/office-chart-ring.svg	pass	38707	11563	27144	0
svgs/oxygen-icons-5.113.0/scalable/actions/small/22x22/office-chart-scatter.svg	pass	73025	4824	68201	0
svgs/oxygen-icons-5.113.0/scalable/actions/small/22x22/page-2sides.svg	pass	7128	2580	4548	0
svgs/oxygen-icons-5.113.0/scalable/actions/small/22x22/page-3sides.svg	pass	6345	2120	4225	0
svgs/oxygen-icons-5.113.0/scalable/actions/small/22x22/page-4sides.svg	pass	12959	3922	9037	0
svgs/oxygen-icons-5.113.0/scalable/actions/small/22x22/page-simple.svg	pass	34942	1376	33566	0
svgs/oxygen-icons-5.113.0/scalable/actions/small/22x22/page-zoom.svg	mismatch	102649	19379	83270	6
svgs/oxygen-icons-5.113.0/scalable/actions/small/22x22/preferences-activities.svg	pass	521082	13015	508067	0
svgs/oxygen-icons-5.113.0/scalable/actions/small/22x22/preflight-verifier.svg	pass	706430	451188	255242	0
svgs/oxygen-icons-5.113.0/scalable/actions/small/22x22/process-stop.svg	pass	18301	9437	8864	0
svgs/oxygen-icons-5.113.0/scalable/actions/small/22x22/project-development-close-all.svg	pass	258701	18287	240414	0
svgs/oxygen-icons-5.113.0/scalable/actions/small/22x22/project-development-new-template.svg	pass	184427	8306	176121	0
svgs/oxygen-icons-5.113.0/scalable/actions/small/22x22/project-development.svg	pass	56289	3961	52328	0
svgs/oxygen-icons-5.113.0/scalable/actions/small/22x22/project-open.svg	pass	1247257	127559	1119698	0
svgs/oxygen-icons-5.113.0/scalable/actions/small/22x22/quickopen-class.svg	pass	63657	19170	44487	2
svgs/oxygen-icons-5.113.0/scalable/actions/small/22x22/quickopen-file.svg	pass	45164	15856	29308	3
svgs/oxygen-icons-5.113.0/scalable/actions/small/22x22/quickopen-function.svg	pass	93048	17159	75889	1
svgs/oxygen-icons-5.113.0/scalable/actions/small/22x22/quickopen.svg	pass	26858	10610	16248	2
svgs/oxygen-icons-5.113.0/scalable/actions/small/22x22/rating.svg	pass	42535	19506	23029	0
svgs/oxygen-icons-5.113.0/scalable/actions/small/22x22/resource-calendar-child-insert.svg	pass	261848	46564	215284	0
svgs/oxygen-icons-5.113.0/scalable/actions/small/22x22/resource-calendar-child.svg	pass	256901	42596	214305	0
svgs/oxygen-icons-5.113.0/scalable/actions/small/22x22/resource-calendar-insert.svg	pass	259971	43715	216256	0
svgs/oxygen-icons-5.113.0/scalable/actions/small/22x22/resource-group-new.svg	pass	212146	151630	60516	2
svgs/oxygen-icons-5.113.0/scalable/actions/small/22x22/run-build-clean.svg	pass	290011	59851	230160	1
svgs/oxygen-icons-5.113.0/scalable/actions/small/22x22/run-build-configure.svg	pass	543446	61577	481869	0
svgs/oxygen-icons-5.113.0/scalable/actions/small/22x22/run-build-file.svg	pass	262075	41436	220639	0
svgs/oxygen-icons-5.113.0/scalable/actions/small/22x22/run-build-install-root.svg	pass	268192	47889	220303	0
svgs/oxygen-icons-5.113.0/scalable/actions/small/22x22/run-build-install.svg	pass	370033	48554	321479	0
svgs/oxygen-icons-5.113.0/scalable/actions/small/22x22/run-build-prune.svg	pass	316857	79884	236973	2
svgs/oxygen-icons-5.113.0/scalable/actions/small/22x22/run-build.svg	pass	253309	37465	215844	0
svgs/oxygen-icons-5.113.0/scalable/actions/small/22x22/select-rectangular.svg	pass	42793	18346	24447	0
svgs/oxygen-icons-5.113.0/scalable/actions/small/22x22/show-menu.svg	pass	195352	2194	193158	0
svgs/oxygen-icons-5.113.0/scalable/actions/small/22x22/snap-extension.svg	pass	16724	7271	9453	0
svgs/oxygen-icons-5.113.0/scalable/actions/small/22x22/snap-guideline.svg	pass	19318	8319	10999	0
svgs/oxygen-icons-5.113.0/scalable/actions/small/22x22/snap-intersection.svg	pass	12109	4429	7680	0
svgs/oxygen-icons-5.113.0/scalable/actions/small/22x22/snap-node.svg	pass	12678	4995	7683	0
svgs/oxygen-icons-5.113.0/scalable/actions/small/22x22/snap-orthogonal.svg	pass	16312	5616	10696	0
svgs/oxygen-icons-5.113.0/scalable/actions/small/22x22/story-editor.svg	pass	38007	18323	19684	0
svgs/oxygen-icons-5.113.0/scalable/actions/small/22x22/stroke-cap-butt.svg	pass	12384	3247	9137	0
svgs/oxygen-icons-5.113.0/scalable/actions/small/22x22/stroke-cap-round.svg	pass	12484	3215	9269	0
svgs/oxygen-icons-5.113.0/scalable/actions/small/22x22/stroke-cap-square.svg	pass	12401	3122	9279	0
svgs/oxygen-icons-5.113.0/scalable/actions/small/22x22/stroke-join-bevel.svg	pass	13524	3813	9711	0
svgs/oxygen-icons-5.113.0/scalable/actions/small/22x22/stroke-join-miter.svg	pass	13725	3971	9754	0
svgs/oxygen-icons-5.113.0/scalable/actions/small/22x22/stroke-join-round.svg	pass	21901	5250	16651	0
svgs/oxygen-icons-5.113.0/scalable/actions/small/22x22/system-search.svg	pass	92604	52551	40053	0
svgs/oxygen-icons-5.113.0/scalable/actions/small/22x22/tab-close.svg	pass	206400	15752	190648	0
svgs/oxygen-icons-5.113.0/scalable/actions/small/22x22/tab-detach.svg	pass	62447	6658	55789	0
svgs/oxygen-icons-5.113.0/scalable/actions/small/22x22/tab-duplicate.svg	pass	62071	6424	55647	0
svgs/oxygen-icons-5.113.0/scalable/actions/small/22x22/tab-new-background.svg	pass	20095	6459	13636	0
svgs/oxygen-icons-5.113.0/scalable/actions/small/22x22/tag-recents.svg	pass	48667	21211	27456	0
svgs/oxygen-icons-5.113.0/scalable/actions/small/22x22/text-directory.svg	pass	111138	46454	64684	0
svgs/oxygen-icons-5.113.0/scalable/actions/small/22x22/text-field.svg	pass	6136	2046	4090	0
svgs/oxygen-icons-5.113.0/scalable/actions/small/22x22/text-frame-link.svg	pass	17299	5233	12066	0
svgs/oxygen-icons-5.113.0/scalable/actions/small/22x22/text-frame-unlink.svg	pass	23363	5312	18051	0
svgs/oxygen-icons-5.113.0/scalable/actions/small/22x22/tool-animator.svg	pass	27586	12797	14789	0
svgs/oxygen-icons-5.113.0/scalable/actions/small/22x22/tools-check-spelling.svg	pass	31130	11513	19617	0
svgs/oxygen-icons-5.113.0/scalable/actions/small/22x22/tools-media-optical-burn-image.svg	pass	883910	140555	743355	0
svgs/oxygen-icons-5.113.0/scalable/actions/small/22x22/tools-media-optical-copy.svg	pass	1687498	242162	1445336	0
svgs/oxygen-icons-5.113.0/scalable/actions/small/22x22/tools-media-optical-erase.svg	pass	110259	21363	88896	0
svgs/oxygen-icons-5.113.0/scalable/actions/small/22x22/tools-media-optical-format.svg	pass	60963	32893	28070	0
svgs/oxygen-icons-5.113.0/scalable/actions/small/22x22/tools-rip-audio-cd.svgz.svg	pass	55882	30142	25740	0
svgs/oxygen-icons-5.113.0/scalable/actions/small/22x22/tools-rip-video-cd.svg	pass	77822	43127	34695	0
svgs/oxygen-icons-5.113.0/scalable/actions/small/22x22/tools-rip-video-dvd.svg	pass	92261	44752	47509	0
svgs/oxygen-icons-5.113.0/scalable/actions/small/22x22/transform-crop-and-resize.svg	pass	177242	18225	159017	0
svgs/oxygen-icons-5.113.0/scalable/actions/small/22x22/transform-crop.svg	pass	34440	17882	16558	0
svgs/oxygen-icons-5.113.0/scalable/actions/small/22x22/transform-rotate.svg	pass	16569	5437	11132	0
svgs/oxygen-icons-5.113.0/scalable/actions/small/22x22/transform-scale.svg	pass	18715	5841	12874	0
svgs/oxygen-icons-5.113.0/scalable/actions/small/22x22/transform-shear-down.svg	pass	13364	4391	8973	0
svgs/oxygen-icons-5.113.0/scalable/actions/small/22x22/transform-shear-right.svg	pass	12637	4194	8443	0
svgs/oxygen-icons-5.113.0/scalable/actions/small/22x22/transform-shear-up.svg	pass	13727	4213	9514	0
svgs/oxygen-icons-5.113.0/scalable/actions/small/22x22/trash-empty.svg	pass	253425	10002	243423	0
svgs/oxygen-icons-5.113.0/scalable/actions/small/22x22/user-group-delete.svg	pass	678798	92450	586348	0
svgs/oxygen-icons-5.113.0/scalable/actions/small/22x22/user-group-new.svg	pass	560434	92018	468416	0
svgs/oxygen-icons-5.113.0/scalable/actions/small/22x22/user-group-properties.svg	pass	553811	100251	453560	0
svgs/oxygen-icons-5.113.0/scalable/actions/small/22x22/view-bank.svg	pass	256021	17893	238128	0
svgs/oxygen-icons-5.113.0/scalable/actions/small/22x22/view-barcode-add.svg	pass	246233	9699	236534	0
svgs/oxygen-icons-5.113.0/scalable/actions/small/22x22/view-barcode.svg	pass	70415	3195	67220	0
svgs/oxygen-icons-5.113.0/scalable/actions/small/22x22/view-calendar-agenda.svg	pass	43197	7619	35578	0
svgs/oxygen-icons-5.113.0/scalable/actions/small/22x22/view-calendar-birthday.svg	pass	54849	25779	29070	0
svgs/oxygen-icons-5.113.0/scalable/actions/small/22x22/view-calendar-day.svg	pass	75482	37153	38329	0
svgs/oxygen-icons-5.113.0/scalable/actions/small/22x22/view-calendar-holiday.svg	pass	28932	7251	21681	0
svgs/oxygen-icons-5.113.0/scalable/actions/small/22x22/view-calendar-journal.svg	pass	337192	60811	276381	1
svgs/oxygen-icons-5.113.0/scalable/actions/small/22x22/view-calendar-list.svg	pass	78978	10441	68537	0
svgs/oxygen-icons-5.113.0/scalable/actions/small/22x22/view-calendar-month.svg	pass	107920	55200	52720	0
svgs/oxygen-icons-5.113.0/scalable/actions/small/22x22/view-calendar-special-occasion.svg	pass	97931	49334	48597	0
svgs/oxygen-icons-5.113.0/scalable/actions/small/22x22/view-calendar-tasks.svg	pass	128607	25138	103469	1
svgs/oxygen-icons-5.113.0/scalable/actions/small/22x22/view-calendar-time-spent.svg	pass	136535	21091	115444	1
svgs/oxygen-icons-5.113.0/scalable/actions/small/22x22/view-calendar-timeline.svg	pass	44137	6076	38061	0
svgs/oxygen-icons-5.113.0/scalable/actions/small/22x22/view-calendar-upcoming-days.svg	pass	77513	38305	39208	0
svgs/oxygen-icons-5.113.0/scalable/actions/small/22x22/view-calendar-upcoming-events.svg	pass	84723	36579	48144	0
svgs/oxygen-icons-5.113.0/scalable/actions/small/22x22/view-calendar-wedding-anniversary.svg	pass	25407	12197	13210	0
svgs/oxygen-icons-5.113.0/scalable/actions/small/22x22/view-calendar-week.svg	pass	81444	40617	40827	0
svgs/oxygen-icons-5.113.0/scalable/actions/small/22x22/view-calendar-whatsnext.svg	pass	308928	104472	204456	0
svgs/oxygen-icons-5.113.0/scalable/actions/small/22x22/view-calendar-workweek.svg	pass	79479	39461	40018	0
svgs/oxygen-icons-5.113.0/scalable/actions/small/22x22/view-calendar.svg	pass	88399	36644	51755	0
svgs/oxygen-icons-5.113.0/scalable/actions/small/22x22/view-certificate-add.svg	pass	782125	77354	704771	0
svgs/oxygen-icons-5.113.0/scalable/actions/small/22x22/view-certificate-export-secret.svg	pass	161904	42885	119019	0
svgs/oxygen-icons-5.113.0/scalable/actions/small/22x22/view-certificate-export-server.svg	pass	948682	402373	546309	0
svgs/oxygen-icons-5.113.0/scalable/actions/small/22x22/view-certificate-export.svg	pass	203495	69100	134395	0
svgs/oxygen-icons-5.113.0/scalable/actions/small/22x22/view-certificate-import.svg	pass	181581	43001	138580	0
svgs/oxygen-icons-5.113.0/scalable/actions/small/22x22/view-certificate-server-configure.svg	pass	978127	425209	552918	0
svgs/oxygen-icons-5.113.0/scalable/actions/small/22x22/view-certificate-sign.svg	pass	234686	84438	150248	0
svgs/oxygen-icons-5.113.0/scalable/actions/small/22x22/view-certificate.svg	pass	200915	67900	133015	0
svgs/oxygen-icons-5.113.0/scalable/actions/small/22x22/view-choose.svg	pass	88748	12113	76635	0
svgs/oxygen-icons-5.113.0/scalable/actions/small/22x22/view-close.svg	pass	83467	7126	76341	0
svgs/oxygen-icons-5.113.0/scalable/actions/small/22x22/view-conversation-balloon.svg	pass	41194	14663	26531	0
svgs/oxygen-icons-5.113.0/scalable/actions/small/22x22/view-file-columns.svg	pass	79864	8075	71789	0
svgs/oxygen-icons-5.113.0/scalable/actions/small/22x22/view-financial-forecast.svg	pass	20068	8830	11238	0
svgs/oxygen-icons-5.113.0/scalable/actions/small/22x22/view-form-action.svg	pass	105615	13476	92139	0
svgs/oxygen-icons-5.113.0/scalable/actions/small/22x22/view-form-table.svg	pass	54149	3160	50989	0
svgs/oxygen-icons-5.113.0/scalable/actions/small/22x22/view-form.svg	pass	63970	7674	56296	1
svgs/oxygen-icons-5.113.0/scalable/actions/small/22x22/view-fullscreen.svg	pass	500319	7101	493218	0
svgs/oxygen-icons-5.113.0/scalable/actions/small/22x22/view-grid.svg	pass	24989	4923	20066	0
svgs/oxygen-icons-5.113.0/scalable/actions/small/22x22/view-group.svg	pass	92380	12763	79617	0
svgs/oxygen-icons-5.113.0/scalable/actions/small/22x22/view-history.svg	pass	44803	21172	23631	0
svgs/oxygen-icons-5.113.0/scalable/actions/small/22x22/view-ldap-resource.svg	pass	1638797	849561	789236	0
svgs/oxygen-icons-5.113.0/scalable/actions/small/22x22/view-left-close.svg	pass	81357	8915	72442	0
svgs/oxygen-icons-5.113.0/scalable/actions/small/22x22/view-list-details.svg	pass	87886	11839	76047	0
svgs/oxygen-icons-5.113.0/scalable/actions/small/22x22/view-list-icons.svg	pass	81360	9411	71949	0
svgs/oxygen-icons-5.113.0/scalable/actions/small/22x22/view-list-text.svg	pass	83463	7868	75595	0
svgs/oxygen-icons-5.113.0/scalable/actions/small/22x22/view-list-tree.svg	pass	88007	11564	76443	0
svgs/oxygen-icons-5.113.0/scalable/actions/small/22x22/view-media-artist.svg	pass	8374	3147	5227	0
svgs/oxygen-icons-5.113.0/scalable/actions/small/22x22/view-media-equalizer.svg	pass	139587	9854	129733	0
svgs/oxygen-icons-5.113.0/scalable/actions/small/22x22/view-media-lyrics.svg	pass	181847	36858	144989	0
svgs/oxygen-icons-5.113.0/scalable/actions/small/22x22/view-media-playlist.svg	pass	130391	30178	100213	0
svgs/oxygen-icons-5.113.0/scalable/actions/small/22x22/view-multiple-objects.svg	pass	11824	3569	8255	0
svgs/oxygen-icons-5.113.0/scalable/actions/small/22x22/view-pim-calendar.svg	pass	220628	12078	208550	0
svgs/oxygen-icons-5.113.0/scalable/actions/small/22x22/view-pim-contacts.svg	pass	82191	42039	40152	0
svgs/oxygen-icons-5.113.0/scalable/actions/small/22x22/view-pim-journal.svg	pass	105505	15367	90138	0
svgs/oxygen-icons-5.113.0/scalable/actions/small/22x22/view-pim-mail.svg	pass	219456	48826	170630	4
svgs/oxygen-icons-5.113.0/scalable/actions/small/22x22/view-pim-news.svg	pass	423467	8521	414946	0
svgs/oxygen-icons-5.113.0/scalable/actions/small/22x22/view-pim-notes.svg	pass	43422	5798	37624	0
svgs/oxygen-icons-5.113.0/scalable/actions/small/22x22/view-pim-tasks-pending.svg	pass	148413	33967	114446	0
svgs/oxygen-icons-5.113.0/scalable/actions/small/22x22/view-pim-tasks.svg	pass	135241	25677	109564	0
svgs/oxygen-icons-5.113.0/scalable/actions/small/22x22/view-presentation.svg	pass	97102	10408	86694	0
svgs/oxygen-icons-5.113.0/scalable/actions/small/22x22/view-preview.svg	pass	126017	38772	87245	0
svgs/oxygen-icons-5.113.0/scalable/actions/small/22x22/view-refresh.svg	pass	60897	17881	43016	0
svgs/oxygen-icons-5.113.0/scalable/actions/small/22x22/view-resource-calendar.svg	pass	211319	38354	172965	0
svgs/oxygen-icons-5.113.0/scalable/actions/small/22x22/view-restore.svg	pass	500327	7102	493225	0
svgs/oxygen-icons-5.113.0/scalable/actions/small/22x22/view-right-close.svg	pass	81343	8870	72473	0
svgs/oxygen-icons-5.113.0/scalable/actions/small/22x22/view-right-new.svg	pass	81519	8897	72622	0
svgs/oxygen-icons-5.113.0/scalable/actions/small/22x22/view-sort-ascending.svg	pass	15848	6141	9707	0
svgs/oxygen-icons-5.113.0/scalable/actions/small/22x22/view-sort-descending.svg	pass	15851	6176	9675	0
svgs/oxygen-icons-5.113.0/scalable/actions/small/22x22/view-split-left-right.svg	pass	79270	7681	71589	0
svgs/oxygen-icons-5.113.0/scalable/actions/small/22x22/view-split-top-bottom.svg	pass	79297	7707	71590	0
svgs/oxygen-icons-5.113.0/scalable/actions/small/22x22/view-table-of-contents-ltr.svg	pass	36601	12473	24128	3
svgs/oxygen-icons-5.113.0/scalable/actions/small/22x22/view-table-of-contents-rtl.svg	pass	39725	12887	26838	3
svgs/oxygen-icons-5.113.0/scalable/actions/small/22x22/view-task-add.svg	pass	183349	22371	160978	0
svgs/oxygen-icons-5.113.0/scalable/actions/small/22x22/view-task-child-add.svg	pass	87700	14105	73595	0
svgs/oxygen-icons-5.113.0/scalable/actions/small/22x22/view-task-child.svg	pass	78304	9843	68461	0
svgs/oxygen-icons-5.113.0/scalable/actions/small/22x22/view-task.svg	pass	92120	17671	74449	0
svgs/oxygen-icons-5.113.0/scalable/actions/small/22x22/view-time-schedule-baselined-add.svg	pass	108591	24045	84546	0
svgs/oxygen-icons-5.113.0/scalable/actions/small/22x22/view-time-schedule-baselined-remove.svg	mismatch	159979	38141	121838	8
svgs/oxygen-icons-5.113.0/scalable/actions/small/22x22/view-time-schedule-baselined.svg	pass	98892	17894	80998	0
svgs/oxygen-icons-5.113.0/scalable/actions/small/22x22/view-time-schedule-calculus.svg	mismatch	160052	37692	122360	11
svgs/oxygen-icons-5.113.0/scalable/actions/small/22x22/view-time-schedule-child-insert.svg	pass	55567	11387	44180	0
svgs/oxygen-icons-5.113.0/scalable/actions/small/22x22/view-time-schedule-edit.svg	pass	67990	15857	52133	0
svgs/oxygen-icons-5.113.0/scalable/actions/small/22x22/view-time-schedule-insert.svg	pass	58007	9884	48123	0
svgs/oxygen-icons-5.113.0/scalable/actions/small/22x22/view-time-schedule.svg	pass	49021	5622	43399	0
svgs/oxygen-icons-5.113.0/scalable/actions/small/22x22/window-duplicate.svg	pass	272472	19268	253204	0
svgs/oxygen-icons-5.113.0/scalable/actions/small/22x22/window-new.svg	pass	97563	10999	86564	0
svgs/oxygen-icons-5.113.0/scalable/actions/small/22x22/zoom-1-to-2.svg	pass	110891	15348	95543	0
svgs/oxygen-icons-5.113.0/scalable/actions/small/22x22/zoom-2-to-1.svg	pass	110888	15357	95531	0
svgs/oxygen-icons-5.113.0/scalable/actions/small/22x22/zoom-draw.svg	pass	119532	13475	106057	0
svgs/oxygen-icons-5.113.0/scalable/actions/small/22x22/zoom-fit-best.svg	pass	37226	6825	30401	0
svgs/oxygen-icons-5.113.0/scalable/actions/small/22x22/zoom-fit-height.svg	pass	37730	6843	30887	0
svgs/oxygen-icons-5.113.0/scalable/actions/small/22x22/zoom-fit-width.svg	pass	37513	6829	30684	0
svgs/oxygen-icons-5.113.0/scalable/actions/small/22x22/zoom-in.svg	pass	109181	16431	92750	0
svgs/oxygen-icons-5.113.0/scalable/actions/small/22x22/zoom-next.svg	pass	105213	12815	92398	0
svgs/oxygen-icons-5.113.0/scalable/actions/small/22x22/zoom-original.svg	pass	110443	16195	94248	0
svgs/oxygen-icons-5.113.0/scalable/actions/small/22x22/zoom-out.svg	pass	107332	13732	93600	0
svgs/oxygen-icons-5.113.0/scalable/actions/small/22x22/zoom-previous.svg	pass	105204	12813	92391	0
svgs/oxygen-icons-5.113.0/scalable/actions/small/22x22/zoom-select.svg	pass	267946	17222	250724	0
svgs/oxygen-icons-5.113.0/scalable/actions/small/32x32/address-book-new.svg	pass	3207830	2329781	878049	0
svgs/oxygen-icons-5.113.0/scalable/actions/small/32x32/align-horizontal-bottom-out.svg	pass	12316	4149	8167	0
svgs/oxygen-icons-5.113.0/scalable/actions/small/32x32/align-horizontal-center.svg	pass	9420	3710	5710	0
svgs/oxygen-icons-5.113.0/scalable/actions/small/32x32/align-horizontal-left-out.svg	pass	12076	4018	8058	0
svgs/oxygen-icons-5.113.0/scalable/actions/small/32x32/align-horizontal-left.svg	pass	8388	3240	5148	0
svgs/oxygen-icons-5.113.0/scalable/actions/small/32x32/align-horizontal-right-out.svg	pass	15634	4022	11612	0
svgs/oxygen-icons-5.113.0/scalable/actions/small/32x32/align-horizontal-right.svg	pass	8393	3245	5148	0
svgs/oxygen-icons-5.113.0/scalable/actions/small/32x32/align-horizontal-top-out.svg	pass	12307	4152	8155	0
svgs/oxygen-icons-5.113.0/scalable/actions/small/32x32/align-vertical-bottom.svg	pass	8609	3409	5200	0
svgs/oxygen-icons-5.113.0/scalable/actions/small/32x32/align-vertical-center.svg	pass	9370	3874	5496	0
svgs/oxygen-icons-5.113.0/scalable/actions/small/32x32/align-vertical-top.svg	pass	8566	3384	5182	0
svgs/oxygen-icons-5.113.0/scalable/actions/small/32x32/archive-extract.svg	pass	24820	8999	15821	0
svgs/oxygen-icons-5.113.0/scalable/actions/small/32x32/archive-insert-directory.svg	pass	371932	125430	246502	0
svgs/oxygen-icons-5.113.0/scalable/actions/small/32x32/archive-insert.svg	pass	34848	15965	18883	0
svgs/oxygen-icons-5.113.0/scalable/actions/small/32x32/archive-remove.svg	pass	46347	19903	26444	0
svgs/oxygen-icons-5.113.0/scalable/actions/small/32x32/bookmark-new.svg	pass	29398	9608	19790	0
svgs/oxygen-icons-5.113.0/scalable/actions/small/32x32/bookmarks-organize.svg	pass	804928	396667	408261	0
svgs/oxygen-icons-5.113.0/scalable/actions/small/32x32/call-start.svg	pass	43818	7965	35853	0
svgs/oxygen-icons-5.113.0/scalable/actions/small/32x32/call-stop.svg	pass	60519	7738	52781	0
svgs/oxygen-icons-5.113.0/scalable/actions/small/32x32/checkbox.svg	pass	46260	11810	34450	0
svgs/oxygen-icons-5.113.0/scalable/actions/small/32x32/code-block.svg	pass	42765	10086	32679	0
svgs/oxygen-icons-5.113.0/scalable/actions/small/32x32/code-class.svg	pass	41100	9770	31330	0
svgs/oxygen-icons-5.113.0/scalable/actions/small/32x32/code-context.svg	pass	146896	6437	140459	0
svgs/oxygen-icons-5.113.0/scalable/actions/small/32x32/code-function.svg	pass	36662	6302	30360	0
svgs/oxygen-icons-5.113.0/scalable/actions/small/32x32/code-typedef.svg	pass	15255	7106	8149	0
svgs/oxygen-icons-5.113.0/scalable/actions/small/32x32/code-variable.svg	pass	11785	4992	6793	0
svgs/oxygen-icons-5.113.0/scalable/actions/small/32x32/color-picker-black.svg	pass	43036	21071	21965	0
svgs/oxygen-icons-5.113.0/scalable/actions/small/32x32/color-picker-grey.svg	pass	42720	20747	21973	0
svgs/oxygen-icons-5.113.0/scalable/actions/small/32x32/color-picker-white.svg	pass	41946	20360	21586	0
svgs/oxygen-icons-5.113.0/scalable/actions/small/32x32/color-picker.svg	pass	35073	17529	17544	0
svgs/oxygen-icons-5.113.0/scalable/actions/small/32x32/contact-new.svg	pass	275612	114013	161599	0
svgs/oxygen-icons-5.113.0/scalable/actions/small/32x32/dashboard-show.svg	pass	252831	129513	123318	0
svgs/oxygen-icons-5.113.0/scalable/actions/small/32x32/debug-execute-from-cursor.svg	pass	208163	7667	200496	0
svgs/oxygen-icons-5.113.0/scalable/actions/small/32x32/debug-execute-to-cursor.svg	pass	208154	7671	200483	0
svgs/oxygen-icons-5.113.0/scalable/actions/small/32x32/debug-run-cursor.svg	pass	511755	45619	466136	0
svgs/oxygen-icons-5.113.0/scalable/actions/small/32x32/debug-run.svg	pass	394332	42605	351727	0
svgs/oxygen-icons-5.113.0/scalable/actions/small/32x32/debug-step-instruction.svg	pass	69200	8225	60975	0
svgs/oxygen-icons-5.113.0/scalable/actions/small/32x32/debug-step-into-instruction.svg	pass	70254	8946	61308	0
svgs/oxygen-icons-5.113.0/scalable/actions/small/32x32/debug-step-into.svg	pass	69839	8743	61096	0
svgs/oxygen-icons-5.113.0/scalable/actions/small/32x32/debug-step-out.svg	pass	69247	8312	60935	0
svgs/oxygen-icons-5.113.0/scalable/actions/small/32x32/debug-step-over.svg	pass	68840	7980	60860	0
svgs/oxygen-icons-5.113.0/scalable/actions/small/32x32/distribute-horizontal-center.svg	pass	51460	4683	46777	0
svgs/oxygen-icons-5.113.0/scalable/actions/small/32x32/distribute-horizontal-equal.svg	pass	51445	4686	46759	0
svgs/oxygen-icons-5.113.0/scalable/actions/small/32x32/distribute-horizontal-left.svg	pass	51450	4684	46766	0
svgs/oxygen-icons-5.113.0/scalable/actions/small/32x32/distribute-horizontal-margin.svg	pass	8929	3410	5519	0
svgs/oxygen-icons-5.113.0/scalable/actions/small/32x32/distribute-horizontal-page.svg	pass	550041	8198	541843	0
svgs/oxygen-icons-5.113.0/scalable/actions/small/32x32/distribute-horizontal-right.svg	pass	51456	4683	46773	0
svgs/oxygen-icons-5.113.0/scalable/actions/small/32x32/distribute-horizontal-x.svg	pass	9915	3387	6528	0
svgs/oxygen-icons-5.113.0/scalable/actions/small/32x32/distribute-vertical-bottom.svg	pass	51860	4960	46900	0
svgs/oxygen-icons-5.113.0/scalable/actions/small/32x32/distribute-vertical-center.svg	pass	51858	4961	46897	0
svgs/oxygen-icons-5.113.0/scalable/actions/small/32x32/distribute-vertical-equal.svg	pass	51867	4962	46905	0
svgs/oxygen-icons-5.113.0/scalable/actions/small/32x32/distribute-vertical-margin.svg	pass	8914	3424	5490	0
svgs/oxygen-icons-5.113.0/scalable/actions/small/32x32/distribute-vertical-page.svg	pass	556979	8216	548763	0
svgs/oxygen-icons-5.113.0/scalable/actions/small/32x32/distribute-vertical-top.svg	pass	51851	4961	46890	0
svgs/oxygen-icons-5.113.0/scalable/actions/small/32x32/distribute-vertical-y.svg	pass	9081	3535	5546	0
svgs/oxygen-icons-5.113.0/scalable/actions/small/32x32/document-edit-decrypt-verify.svg	pass	112591	63043	49548	0
svgs/oxygen-icons-5.113.0/scalable/actions/small/32x32/document-edit-decrypt.svg	pass	140860	84530	56330	0
svgs/oxygen-icons-5.113.0/scalable/actions/small/32x32/document-edit-encrypt.svg	pass	648461	83507	564954	0
svgs/oxygen-icons-5.113.0/scalable/actions/small/32x32/document-edit-sign-encrypt.svg	pass	115400	68316	47084	0
svgs/oxygen-icons-5.113.0/scalable/actions/small/32x32/document-edit-sign.svg	pass	238828	146026	92802	0
svgs/oxygen-icons-5.113.0/scalable/actions/small/32x32/document-edit-verify.svg	pass	279673	183855	95818	0
svgs/oxygen-icons-5.113.0/scalable/actions/small/32x32/document-edit.svg	pass	559562	17522	542040	0
svgs/oxygen-icons-5.113.0/scalable/actions/small/32x32/document-encripted.svg	pass	42884	14681	28203	0
svgs/oxygen-icons-5.113.0/scalable/actions/small/32x32/document-export-table.svg	pass	130921	17623	113298	0
svgs/oxygen-icons-5.113.0/scalable/actions/small/32x32/document-export.svg	pass	24007	8873	15134	0
svgs/oxygen-icons-5.113.0/scalable/actions/small/32x32/document-import.svg	pass	27037	10505	16532	0
svgs/oxygen-icons-5.113.0/scalable/actions/small/32x32/document-open-folder.svg	pass	511128	236707	274421	0
svgs/oxygen-icons-5.113.0/scalable/actions/small/32x32/document-open-remote.svg	pass	1170433	565033	605400	0
svgs/oxygen-icons-5.113.0/scalable/actions/small/32x32/document-open.svg	pass	511956	236755	275201	0
svgs/oxygen-icons-5.113.0/scalable/actions/small/32x32/documentation.svg	mismatch	154645	50488	104157	23
svgs/oxygen-icons-5.113.0/scalable/actions/small/32x32/download-later.svg	pass	66413	17031	49382	0
svgs/oxygen-icons-5.113.0/scalable/actions/small/32x32/download.svg	pass	666874	345499	321375	0
svgs/oxygen-icons-5.113.0/scalable/actions/small/32x32/draw-arrow-back.svg	pass	7244	2527	4717	0
svgs/oxygen-icons-5.113.0/scalable/actions/small/32x32/draw-arrow-down.svg	pass	7136	2363	4773	0
svgs/oxygen-icons-5.113.0/scalable/actions/small/32x32/draw-arrow-forward.svg	pass	6456	2338	4118	0
svgs/oxygen-icons-5.113.0/scalable/actions/small/32x32/draw-arrow-up.svg	pass	6465	2363	4102	0
svgs/oxygen-icons-5.113.0/scalable/actions/small/32x32/draw-bezier-curves.svg	pass	16545	5805	10740	0
svgs/oxygen-icons-5.113.0/scalable/actions/small/32x32/draw-circle.svg	pass	6184	1993	4191	0
svgs/oxygen-icons-5.113.0/scalable/actions/small/32x32/draw-cross.svg	pass	6839	2757	4082	0
svgs/oxygen-icons-5.113.0/scalable/actions/small/32x32/draw-donut.svg	pass	7391	2612	4779	0
svgs/oxygen-icons-5.113.0/scalable/actions/small/32x32/draw-ellipse.svg	pass	6107	1981	4126	0
svgs/oxygen-icons-5.113.0/scalable/actions/small/32x32/draw-freehand.svg	pass	31643	13019	18624	0
svgs/oxygen-icons-5.113.0/scalable/actions/small/32x32/draw-halfcircle1.svg	pass	5960	1903	4057	0
svgs/oxygen-icons-5.113.0/scalable/actions/small/32x32/draw-halfcircle2.svg	pass	5962	1878	4084	0
svgs/oxygen-icons-5.113.0/scalable/actions/small/32x32/draw-halfcircle3.svg	pass	6216	1974	4242	0
svgs/oxygen-icons-5.113.0/scalable/actions/small/32x32/draw-halfcircle4.svg	pass	6812	1838	4974	0
svgs/oxygen-icons-5.113.0/scalable/actions/small/32x32/draw-path.svg	pass	39633	10103	29530	0
svgs/oxygen-icons-5.113.0/scalable/actions/small/32x32/draw-polygon.svg	pass	5993	1874	4119	0
svgs/oxygen-icons-5.113.0/scalable/actions/small/32x32/draw-polyline.svg	pass	36436	1959	34477	0
svgs/oxygen-icons-5.113.0/scalable/actions/small/32x32/draw-spiral.svg	pass	11274	3227	8047	0
svgs/oxygen-icons-5.113.0/scalable/actions/small/32x32/draw-square-inverted-corners.svg	pass	6700	2053	4647	0
svgs/oxygen-icons-5.113.0/scalable/actions/small/32x32/draw-star.svg	pass	5895	1972	3923	0
svgs/oxygen-icons-5.113.0/scalable/actions/small/32x32/draw-text.svg	pass	8430	1389	7041	0
svgs/oxygen-icons-5.113.0/scalable/actions/small/32x32/draw-triangle.svg	pass	5896	1894	4002	0
svgs/oxygen-icons-5.113.0/scalable/actions/small/32x32/draw-triangle1.svg	pass	34930	1845	33085	0
svgs/oxygen-icons-5.113.0/scalable/actions/small/32x32/draw-triangle2.svg	pass	6112	1895	4217	0
svgs/oxygen-icons-5.113.0/scalable/actions/small/32x32/draw-triangle3.svg	pass	6146	1902	4244	0
svgs/oxygen-icons-5.113.0/scalable/actions/small/32x32/draw-triangle4.svg	pass	5870	1890	3980	0
svgs/oxygen-icons-5.113.0/scalable/actions/small/32x32/edit-clear-list.svg	pass	207043	15642	191401	0
svgs/oxygen-icons-5.113.0/scalable/actions/small/32x32/edit-find-mail.svg	pass	122288	21754	100534	0
svgs/oxygen-icons-5.113.0/scalable/actions/small/32x32/edit-find-project.svg	pass	88127	20533	67594	0
svgs/oxygen-icons-5.113.0/scalable/actions/small/32x32/edit-find-replace.svg	pass	708860	77513	631347	0
svgs/oxygen-icons-5.113.0/scalable/actions/small/32x32/edit-find.svg	pass	183520	71342	112178	2
svgs/oxygen-icons-5.113.0/scalable/actions/small/32x32/edit-guides.svg	pass	28969	3922	25047	0
svgs/oxygen-icons-5.113.0/scalable/actions/small/32x32/edit-image-face-add.svg	pass	237651	47125	190526	0
svgs/oxygen-icons-5.113.0/scalable/actions/small/32x32/edit-image-face-detect.svg	pass	17605	3349	14256	0
svgs/oxygen-icons-5.113.0/scalable/actions/small/32x32/edit-image-face-recognize.svg	mismatch	154246	45420	108826	9
svgs/oxygen-icons-5.113.0/scalable/actions/small/32x32/edit-image-face-show.svg	pass	913156	84547	828609	0
svgs/oxygen-icons-5.113.0/scalable/actions/small/32x32/edit-node.svg	pass	29050	3972	25078	0
svgs/oxygen-icons-5.113.0/scalable/actions/small/32x32/edit-paste.svg	pass	88610	15054	73556	0
svgs/oxygen-icons-5.113.0/scalable/actions/small/32x32/edit-select-all.svg	pass	200363	111882	88481	0
svgs/oxygen-icons-5.113.0/scalable/actions/small/32x32/edit-select-none.svg	pass	232353	122575	109778	0
svgs/oxygen-icons-5.113.0/scalable/actions/small/32x32/edit-select.svg	pass	25174	2708	22466	0
svgs/oxygen-icons-5.113.0/scalable/actions/small/32x32/edit-table-cell-merge.svg	pass	271792	4691	267101	0
svgs/oxygen-icons-5.113.0/scalable/actions/small/32x32/edit-table-cell-split.svg	pass	264970	4249	260721	0
svgs/oxygen-icons-5.113.0/scalable/actions/small/32x32/edit-table-delete-column.svg	mismatch	328276	19651	308625	5
svgs/oxygen-icons-5.113.0/scalable/actions/small/32x32/edit-table-delete-row.svg	mismatch	330583	19196	311387	5
svgs/oxygen-icons-5.113.0/scalable/actions/small/32x32/edit-table-insert-column-left.svg	pass	276571	12043	264528	0
svgs/oxygen-icons-5.113.0/scalable/actions/small/32x32/edit-table-insert-column-right.svg	pass	467658	13433	454225	0
svgs/oxygen-icons-5.113.0/scalable/actions/small/32x32/edit-table-insert-row-above.svg	pass	531952	16898	515054	0
svgs/oxygen-icons-5.113.0/scalable/actions/small/32x32/edit-table-insert-row-below.svg	pass	532013	16923	515090	0
svgs/oxygen-icons-5.113.0/scalable/actions/small/32x32/edit-text-frame-update.svg	pass	22314	4371	17943	0
svgs/oxygen-icons-5.113.0/scalable/actions/small/32x32/folder-new.svg	pass	371932	125430	246502	0
svgs/oxygen-icons-5.113.0/scalable/actions/small/32x32/folder-sync.svg	pass	502727	233324	269403	0
svgs/oxygen-icons-5.113.0/scalable/actions/small/32x32/format-add-node.svg	pass	31094	5932	25162	0
svgs/oxygen-icons-5.113.0/scalable/actions/small/32x32/format-break-node.svg	pass	32120	5847	26273	0
svgs/oxygen-icons-5.113.0/scalable/actions/small/32x32/format-connect-node.svg	pass	35035	7498	27537	0
svgs/oxygen-icons-5.113.0/scalable/actions/small/32x32/format-disconnect-node.svg	pass	33646	6943	26703	0
svgs/oxygen-icons-5.113.0/scalable/actions/small/32x32/format-remove-node.svg	pass	56270	14740	41530	0
svgs/oxygen-icons-5.113.0/scalable/actions/small/32x32/games-achievements.svg	pass	635795	139808	495987	0
svgs/oxygen-icons-5.113.0/scalable/actions/small/32x32/games-highscores.svg	pass	288323	143872	144451	1
svgs/oxygen-icons-5.113.0/scalable/actions/small/32x32/go-first-view-page.svg	pass	44174	24483	19691	0
svgs/oxygen-icons-5.113.0/scalable/actions/small/32x32/go-jump-declaration.svg	pass	115990	15788	100202	0
svgs/oxygen-icons-5.113.0/scalable/actions/small/32x32/go-jump-definition.svg	pass	129256	7274	121982	0
svgs/oxygen-icons-5.113.0/scalable/actions/small/32x32/go-jump-locationbar.svg	pass	643051	341384	301667	0
svgs/oxygen-icons-5.113.0/scalable/actions/small/32x32/go-last-view-page.svg	pass	186209	24718	161491	0
svgs/oxygen-icons-5.113.0/scalable/actions/small/32x32/go-next-context.svg	pass	18062	7955	10107	0
svgs/oxygen-icons-5.113.0/scalable/actions/small/32x32/go-next-use.svg	pass	66498	7047	59451	0
svgs/oxygen-icons-5.113.0/scalable/actions/small/32x32/go-next-view-page.svg	pass	114470	18221	96249	0
svgs/oxygen-icons-5.113.0/scalable/actions/small/32x32/go-previous-context.svg	pass	15251	6953	8298	0
svgs/oxygen-icons-5.113.0/scalable/actions/small/32x32/go-previous-use.svg	pass	134545	7191	127354	0
svgs/oxygen-icons-5.113.0/scalable/actions/small/32x32/go-previous-view-page.svg	pass	114298	18184	96114	0
svgs/oxygen-icons-5.113.0/scalable/actions/small/32x32/help-about.svg	pass	107133	11337	95796	0
svgs/oxygen-icons-5.113.0/scalable/actions/small/32x32/help-contents.svg	pass	1198086	575038	623048	0
svgs/oxygen-icons-5.113.0/scalable/actions/small/32x32/help-contextual.svg	pass	420043	186864	233179	0
svgs/oxygen-icons-5.113.0/scalable/actions/small/32x32/help-donate.svg	pass	145219	14363	130856	0
svgs/oxygen-icons-5.113.0/scalable/actions/small/32x32/help-feedback.svg	pass	56119	16638	39481	0
svgs/oxygen-icons-5.113.0/scalable/actions/small/32x32/im-aim.svg	pass	33256	14504	18752	0
svgs/oxygen-icons-5.113.0/scalable/actions/small/32x32/im-ban-kick-user.svg	mismatch	105270	49751	55519	13
svgs/oxygen-icons-5.113.0/scalable/actions/small/32x32/im-ban-user.svg	mismatch	63148	29160	33988	30
svgs/oxygen-icons-5.113.0/scalable/actions/small/32x32/im-facebook.svg	pass	13408	3961	9447	0
svgs/oxygen-icons-5.113.0/scalable/actions/small/32x32/im-gadugadu.svg	pass	25721	10759	14962	0
svgs/oxygen-icons-5.113.0/scalable/actions/small/32x32/im-google-talk.svg	pass	28329	11721	16608	0
svgs/oxygen-icons-5.113.0/scalable/actions/small/32x32/im-google.svg	mismatch	39645	12192	27453	27
svgs/oxygen-icons-5.113.0/scalable/actions/small/32x32/im-icq.svg	pass	70405	25773	44632	0
svgs/oxygen-icons-5.113.0/scalable/actions/small/32x32/im-identi.ca.svg	pass	35420	23522	11898	0
svgs/oxygen-icons-5.113.0/scalable/actions/small/32x32/im-jabber.svg	pass	54255	17094	37161	0
svgs/oxygen-icons-5.113.0/scalable/actions/small/32x32/im-kick-user.svg	pass	240669	28828	211841	0
svgs/oxygen-icons-5.113.0/scalable/actions/small/32x32/im-msn.svg	pass	70825	26005	44820	0
svgs/oxygen-icons-5.113.0/scalable/actions/small/32x32/im-qq.svg	pass	55153	20437	34716	0
svgs/oxygen-icons-5.113.0/scalable/actions/small/32x32/im-skype.svg	pass	43818	7965	35853	0
svgs/oxygen-icons-5.113.0/scalable/actions/small/32x32/im-twitter.svg	pass	41411	7061	34350	0
svgs/oxygen-icons-5.113.0/scalable/actions/small/32x32/im-user-away.svg	pass	158604	24344	134260	0
svgs/oxygen-icons-5.113.0/scalable/actions/small/32x32/im-user-busy.svg	pass	65322	35145	30177	0
svgs/oxygen-icons-5.113.0/scalable/actions/small/32x32/im-yahoo.svg	pass	47620	22443	25177	0
svgs/oxygen-icons-5.113.0/scalable/actions/small/32x32/list-resource-add.svg	pass	216168	146935	69233	0
svgs/oxygen-icons-5.113.0/scalable/actions/small/32x32/mail-encrypted-.svg	pass	480814	263719	217095	0
svgs/oxygen-icons-5.113.0/scalable/actions/small/32x32/mail-encrypted-full.svg	pass	453336	264165	189171	0
svgs/oxygen-icons-5.113.0/scalable/actions/small/32x32/mail-encrypted-part.svg	pass	442989	241765	201224	0
svgs/oxygen-icons-5.113.0/scalable/actions/small/32x32/mail-forward.svg	pass	177630	73322	104308	0
svgs/oxygen-icons-5.113.0/scalable/actions/small/32x32/mail-forwarded.svg	pass	320027	122548	197479	0
svgs/oxygen-icons-5.113.0/scalable/actions/small/32x32/mail-invitation.svg	pass	260985	12832	248153	0
svgs/oxygen-icons-5.113.0/scalable/actions/small/32x32/mail-mark-important.svg	pass	179056	9227	169829	0
svgs/oxygen-icons-5.113.0/scalable/actions/small/32x32/mail-mark-junk.svg	mismatch	210799	18738	192061	36
svgs/oxygen-icons-5.113.0/scalable/actions/small/32x32/mail-mark-notjunk.svg	pass	19537	8444	11093	0
svgs/oxygen-icons-5.113.0/scalable/actions/small/32x32/mail-mark-read.svg	pass	262123	116899	145224	0
svgs/oxygen-icons-5.113.0/scalable/actions/small/32x32/mail-mark-unread-new.svg	pass	246814	7081	239733	0
svgs/oxygen-icons-5.113.0/scalable/actions/small/32x32/mail-mark-unread.svg	pass	66616	4222	62394	0
svgs/oxygen-icons-5.113.0/scalable/actions/small/32x32/mail-meeting-request-reply.svg	pass	67664	5432	62232	0
svgs/oxygen-icons-5.113.0/scalable/actions/small/32x32/mail-message-new-list.svg	pass	259480	120609	138871	1
svgs/oxygen-icons-5.113.0/scalable/actions/small/32x32/mail-message-new.svg	pass	250153	120475	129678	0
svgs/oxygen-icons-5.113.0/scalable/actions/small/32x32/mail-queue.svg	pass	198035	84352	113683	0
svgs/oxygen-icons-5.113.0/scalable/actions/small/32x32/mail-receive.svg	pass	56488	14189	42299	0
svgs/oxygen-icons-5.113.0/scalable/actions/small/32x32/mail-replied.svg	pass	430229	122064	308165	0
svgs/oxygen-icons-5.113.0/scalable/actions/small/32x32/mail-reply-all.svg	pass	72362	9772	62590	0
svgs/oxygen-icons-5.113.0/scalable/actions/small/32x32/mail-reply-custom-all.svg	pass	66417	6639	59778	2
svgs/oxygen-icons-5.113.0/scalable/actions/small/32x32/mail-reply-custom.svg	pass	70706	6285	64421	0
svgs/oxygen-icons-5.113.0/scalable/actions/small/32x32/mail-reply-list.svg	pass	85668	16706	68962	0
svgs/oxygen-icons-5.113.0/scalable/actions/small/32x32/mail-reply-sender.svg	pass	71969	9534	62435	0
svgs/oxygen-icons-5.113.0/scalable/actions/small/32x32/mail-send.svg	pass	191620	80678	110942	0
svgs/oxygen-icons-5.113.0/scalable/actions/small/32x32/mail-signature-unknown.svg	pass	328635	143915	184720	0
svgs/oxygen-icons-5.113.0/scalable/actions/small/32x32/mail-signed-full.svg	pass	236367	133814	102553	0
svgs/oxygen-icons-5.113.0/scalable/actions/small/32x32/mail-signed-part.svg	pass	210458	111274	99184	0
svgs/oxygen-icons-5.113.0/scalable/actions/small/32x32/mail-signed-verified.svg	pass	287608	142656	144952	0
svgs/oxygen-icons-5.113.0/scalable/actions/small/32x32/mail-signed.svg	pass	272194	133431	138763	0
svgs/oxygen-icons-5.113.0/scalable/actions/small/32x32/mail-tagged.svg	pass	411265	198192	213073	0
svgs/oxygen-icons-5.113.0/scalable/actions/small/32x32/measure.svg	pass	11316	3433	7883	0
svgs/oxygen-icons-5.113.0/scalable/actions/small/32x32/meeting-participant-no-response.svg	pass	283464	149701	133763	0
svgs/oxygen-icons-5.113.0/scalable/actions/small/32x32/meeting-participant-request-response.svg	pass	282720	149566	133154	0
svgs/oxygen-icons-5.113.0/scalable/actions/small/32x32/merge.svg	pass	337783	5137	332646	0
svgs/oxygen-icons-5.113.0/scalable/actions/small/32x32/milestone.svg	pass	365189	118369	246820	0
svgs/oxygen-icons-5.113.0/scalable/actions/small/32x32/news-subscribe.svg	pass	169964	19069	150895	0
svgs/oxygen-icons-5.113.0/scalable/actions/small/32x32/news-unsubscribe.svg	pass	299257	24490	274767	0
svgs/oxygen-icons-5.113.0/scalable/actions/small/32x32/office-chart-area-focus-peak-node.svg	pass	16108	6856	9252	0
svgs/oxygen-icons-5.113.0/scalable/actions/small/32x32/page-2sides.svg	pass	29771	6383	23388	0
svgs/oxygen-icons-5.113.0/scalable/actions/small/32x32/page-3sides.svg	pass	32103	7276	24827	0
svgs/oxygen-icons-5.113.0/scalable/actions/small/32x32/page-4sides.svg	pass	35292	7674	27618	0
svgs/oxygen-icons-5.113.0/scalable/actions/small/32x32/page-simple.svg	pass	26159	5544	20615	0
svgs/oxygen-icons-5.113.0/scalable/actions/small/32x32/page-zoom.svg	pass	78251	18850	59401	0
svgs/oxygen-icons-5.113.0/scalable/actions/small/32x32/preferences-activities.svg	pass	521050	13038	508012	0
svgs/oxygen-icons-5.113.0/scalable/actions/small/32x32/preflight-verifier.svg	pass	704520	450507	254013	0
svgs/oxygen-icons-5.113.0/scalable/actions/small/32x32/project-development-close-all.svg	pass	115672	19745	95927	0
svgs/oxygen-icons-5.113.0/scalable/actions/small/32x32/project-development-close.svg	pass	110328	16092	94236	0
svgs/oxygen-icons-5.113.0/scalable/actions/small/32x32/project-development-new-template.svg	pass	158641	10333	148308	0
svgs/oxygen-icons-5.113.0/scalable/actions/small/32x32/project-development.svg	pass	70864	5974	64890	0
svgs/oxygen-icons-5.113.0/scalable/actions/small/32x32/project-open.svg	pass	134810	120621	14189	0
svgs/oxygen-icons-5.113.0/scalable/actions/small/32x32/quickopen-class.svg	pass	72791	17073	55718	0
svgs/oxygen-icons-5.113.0/scalable/actions/small/32x32/quickopen-function.svg	pass	104472	17180	87292	0
svgs/oxygen-icons-5.113.0/scalable/actions/small/32x32/resource-calendar-child-insert.svg	pass	181415	17166	164249	0
svgs/oxygen-icons-5.113.0/scalable/actions/small/32x32/resource-calendar-child.svg	pass	56472	12873	43599	0
svgs/oxygen-icons-5.113.0/scalable/actions/small/32x32/resource-calendar-insert.svg	pass	130575	42677	87898	0
svgs/oxygen-icons-5.113.0/scalable/actions/small/32x32/resource-group-new.svg	pass	224253	151282	72971	0
svgs/oxygen-icons-5.113.0/scalable/actions/small/32x32/run-build-clean.svg	pass	300614	65438	235176	1
svgs/oxygen-icons-5.113.0/scalable/actions/small/32x32/run-build-configure.svg	pass	402937	65474	337463	0
svgs/oxygen-icons-5.113.0/scalable/actions/small/32x32/run-build-file.svg	pass	231269	42662	188607	0
svgs/oxygen-icons-5.113.0/scalable/actions/small/32x32/run-build-install-root.svg	pass	238686	47470	191216	0
svgs/oxygen-icons-5.113.0/scalable/actions/small/32x32/run-build-install.svg	pass	335125	48386	286739	0
svgs/oxygen-icons-5.113.0/scalable/actions/small/32x32/run-build-prune.svg	pass	333196	89946	243250	0
svgs/oxygen-icons-5.113.0/scalable/actions/small/32x32/run-build.svg	pass	300822	39561	261261	0
svgs/oxygen-icons-5.113.0/scalable/actions/small/32x32/snap-extension.svg	pass	16929	7008	9921	0
svgs/oxygen-icons-5.113.0/scalable/actions/small/32x32/snap-guideline.svg	pass	19461	8128	11333	0
svgs/oxygen-icons-5.113.0/scalable/actions/small/32x32/snap-intersection.svg	pass	13306	4448	8858	0
svgs/oxygen-icons-5.113.0/scalable/actions/small/32x32/snap-node.svg	pass	13171	4736	8435	0
svgs/oxygen-icons-5.113.0/scalable/actions/small/32x32/snap-orthogonal.svg	pass	18945	5198	13747	0
svgs/oxygen-icons-5.113.0/scalable/actions/small/32x32/split.svg	pass	346734	14403	332331	0
svgs/oxygen-icons-5.113.0/scalable/actions/small/32x32/story-editor.svg	pass	35667	17279	18388	0
svgs/oxygen-icons-5.113.0/scalable/actions/small/32x32/stroke-cap-butt.svg	pass	7518	2869	4649	0
svgs/oxygen-icons-5.113.0/scalable/actions/small/32x32/stroke-cap-round.svg	pass	7371	2767	4604	0
svgs/oxygen-icons-5.113.0/scalable/actions/small/32x32/stroke-cap-square.svg	pass	7416	2786	4630	0
svgs/oxygen-icons-5.113.0/scalable/actions/small/32x32/stroke-join-bevel.svg	pass	8492	3302	5190	0
svgs/oxygen-icons-5.113.0/scalable/actions/small/32x32/stroke-join-miter.svg	pass	8476	3284	5192	0
svgs/oxygen-icons-5.113.0/scalable/actions/small/32x32/stroke-join-round.svg	pass	11916	3489	8427	0
svgs/oxygen-icons-5.113.0/scalable/actions/small/32x32/system-search.svg	pass	142636	42075	100561	0
svgs/oxygen-icons-5.113.0/scalable/actions/small/32x32/taxes-finances.svg	pass	458931	62325	396606	0
svgs/oxygen-icons-5.113.0/scalable/actions/small/32x32/text-field.svg	pass	5983	1981	4002	0
svgs/oxygen-icons-5.113.0/scalable/actions/small/32x32/text-frame-link.svg	pass	18223	5359	12864	0
svgs/oxygen-icons-5.113.0/scalable/actions/small/32x32/text-frame-unlink.svg	pass	29056	9392	19664	0
svgs/oxygen-icons-5.113.0/scalable/actions/small/32x32/tool-animator.svg	pass	21817	8226	13591	0
svgs/oxygen-icons-5.113.0/scalable/actions/small/32x32/tools-check-spelling.svg	pass	25216	12066	13150	0
svgs/oxygen-icons-5.113.0/scalable/actions/small/32x32/tools-media-optical-burn-image.svg	pass	77643	41782	35861	0
svgs/oxygen-icons-5.113.0/scalable/actions/small/32x32/tools-media-optical-burn.svg	pass	75172	43598	31574	0
svgs/oxygen-icons-5.113.0/scalable/actions/small/32x32/tools-media-optical-burn2.svg	pass	46871	25675	21196	0
svgs/oxygen-icons-5.113.0/scalable/actions/small/32x32/tools-media-optical-erase.svg	pass	86452	25354	61098	0
svgs/oxygen-icons-5.113.0/scalable/actions/small/32x32/tools-rip-audio-cd.svg	pass	78011	44583	33428	0
svgs/oxygen-icons-5.113.0/scalable/actions/small/32x32/tools-rip-video-cd.svg	pass	76705	34552	42153	0
svgs/oxygen-icons-5.113.0/scalable/actions/small/32x32/tools-rip-video-dvd.svg	pass	92491	38400	54091	0
svgs/oxygen-icons-5.113.0/scalable/actions/small/32x32/transform-shear-down.svg	pass	13268	4157	9111	0
svgs/oxygen-icons-5.113.0/scalable/actions/small/32x32/transform-shear-left.svg	pass	12931	4153	8778	0
svgs/oxygen-icons-5.113.0/scalable/actions/small/32x32/transform-shear-right.svg	pass	12928	4146	8782	0
svgs/oxygen-icons-5.113.0/scalable/actions/small/32x32/transform-shear-up.svg	pass	13881	4097	9784	0
svgs/oxygen-icons-5.113.0/scalable/actions/small/32x32/view-bank-account-checking.svg	pass	488772	88549	400223	0
svgs/oxygen-icons-5.113.0/scalable/actions/small/32x32/view-bank-account-savings.svg	pass	584157	165621	418536	0
svgs/oxygen-icons-5.113.0/scalable/actions/small/32x32/view-bank-account.svg	pass	188954	81638	107316	0
svgs/oxygen-icons-5.113.0/scalable/actions/small/32x32/view-bank.svg	pass	263052	21866	241186	0
svgs/oxygen-icons-5.113.0/scalable/actions/small/32x32/view-barcode-add.svg	pass	244247	8592	235655	0
svgs/oxygen-icons-5.113.0/scalable/actions/small/32x32/view-barcode.svg	pass	70939	3436	67503	0
svgs/oxygen-icons-5.113.0/scalable/actions/small/32x32/view-calendar-agenda.svg	pass	153825	16929	136896	0
svgs/oxygen-icons-5.113.0/scalable/actions/small/32x32/view-calendar-birthday.svg	mismatch	56640	27175	29465	10
svgs/oxygen-icons-5.113.0/scalable/actions/small/32x32/view-calendar-holiday.svg	mismatch	37378	17333	20045	10
svgs/oxygen-icons-5.113.0/scalable/actions/small/32x32/view-calendar-journal.svg	pass	412089	96790	315299	0
svgs/oxygen-icons-5.113.0/scalable/actions/small/32x32/view-calendar-list.svg	pass	92594	14100	78494	0
svgs/oxygen-icons-5.113.0/scalable/actions/small/32x32/view-calendar-special-occasion.svg	mismatch	92495	50056	42439	10
svgs/oxygen-icons-5.113.0/scalable/actions/small/32x32/view-calendar-tasks.svg	pass	88653	13530	75123	0
svgs/oxygen-icons-5.113.0/scalable/actions/small/32x32/view-calendar-time-spent.svg	pass	145481	22081	123400	0
svgs/oxygen-icons-5.113.0/scalable/actions/small/32x32/view-calendar-timeline.svg	pass	64777	14706	50071	0
svgs/oxygen-icons-5.113.0/scalable/actions/small/32x32/view-calendar-wedding-anniversary.svg	mismatch	26300	12971	13329	13
svgs/oxygen-icons-5.113.0/scalable/actions/small/32x32/view-calendar-whatsnext.svg	pass	550129	217532	332597	0
svgs/oxygen-icons-5.113.0/scalable/actions/small/32x32/view-catalog.svg	pass	74042	43499	30543	0
svgs/oxygen-icons-5.113.0/scalable/actions/small/32x32/view-certificate-add.svg	pass	484402	93083	391319	0
svgs/oxygen-icons-5.113.0/scalable/actions/small/32x32/view-certificate-export-server.svg	pass	1592857	425201	1167656	0
svgs/oxygen-icons-5.113.0/scalable/actions/small/32x32/view-certificate-export.svg	pass	651165	89766	561399	0
svgs/oxygen-icons-5.113.0/scalable/actions/small/32x32/view-certificate-import.svg	pass	586929	81985	504944	0
svgs/oxygen-icons-5.113.0/scalable/actions/small/32x32/view-certificate-secret.svg	pass	571586	42439	529147	0
svgs/oxygen-icons-5.113.0/scalable/actions/small/32x32/view-certificate-server-configure.svg	pass	1933003	506523	1426480	0
svgs/oxygen-icons-5.113.0/scalable/actions/small/32x32/view-certificate-sign.svg	pass	681917	104762	577155	0
svgs/oxygen-icons-5.113.0/scalable/actions/small/32x32/view-certificate.svg	pass	243179	87186	155993	0
svgs/oxygen-icons-5.113.0/scalable/actions/small/32x32/view-conversation-balloon.svg	pass	41016	14655	26361	0
svgs/oxygen-icons-5.113.0/scalable/actions/small/32x32/view-credit-card-account.svg	pass	325897	197943	127954	1
svgs/oxygen-icons-5.113.0/scalable/actions/small/32x32/view-currency-list.svg	pass	281993	15121	266872	0
svgs/oxygen-icons-5.113.0/scalable/actions/small/32x32/view-documents-finances.svg	pass	456232	190759	265473	1
svgs/oxygen-icons-5.113.0/scalable/actions/small/32x32/view-expenses-categories.svg	pass	276546	124340	152206	0
svgs/oxygen-icons-5.113.0/scalable/actions/small/32x32/view-financial-categories.svg	pass	417868	183089	234779	1
svgs/oxygen-icons-5.113.0/scalable/actions/small/32x32/view-financial-forecast.svg	pass	18410	8947	9463	0
svgs/oxygen-icons-5.113.0/scalable/actions/small/32x32/view-financial-list.svg	pass	163613	64435	99178	1
svgs/oxygen-icons-5.113.0/scalable/actions/small/32x32/view-financial-payment-mode.svg	pass	616704	177271	439433	0
svgs/oxygen-icons-5.113.0/scalable/actions/small/32x32/view-financial-transfer.svg	pass	348072	28062	320010	0
svgs/oxygen-icons-5.113.0/scalable/actions/small/32x32/view-form-action.svg	pass	186889	15498	171391	0
svgs/oxygen-icons-5.113.0/scalable/actions/small/32x32/view-form-table.svg	pass	169492	3860	165632	0
svgs/oxygen-icons-5.113.0/scalable/actions/small/32x32/view-form.svg	pass	156832	8174	148658	0
svgs/oxygen-icons-5.113.0/scalable/actions/small/32x32/view-grid.svg	pass	36206	4107	32099	0
svgs/oxygen-icons-5.113.0/scalable/actions/small/32x32/view-group.svg	pass	129587	32264	97323	0
svgs/oxygen-icons-5.113.0/scalable/actions/small/32x32/view-income-categories.svg	pass	243367	130316	113051	0
svgs/oxygen-icons-5.113.0/scalable/actions/small/32x32/view-investment-account.svg	pass	1693075	745813	947262	0
svgs/oxygen-icons-5.113.0/scalable/actions/small/32x32/view-investment.svg	pass	442021	50346	391675	0
svgs/oxygen-icons-5.113.0/scalable/actions/small/32x32/view-ldap-resource.svg	pass	1658369	857281	801088	1
svgs/oxygen-icons-5.113.0/scalable/actions/small/32x32/view-loan-asset.svg	pass	465260	72468	392792	0
svgs/oxygen-icons-5.113.0/scalable/actions/small/32x32/view-loan.svg	pass	465350	72498	392852	0
svgs/oxygen-icons-5.113.0/scalable/actions/small/32x32/view-media-equalizer.svg	pass	209060	8383	200677	0
svgs/oxygen-icons-5.113.0/scalable/actions/small/32x32/view-multiple-objects.svg	pass	17804	6394	11410	0
svgs/oxygen-icons-5.113.0/scalable/actions/small/32x32/view-pim-contacts.svg	pass	236553	110325	126228	0
svgs/oxygen-icons-5.113.0/scalable/actions/small/32x32/view-pim-journal.svg	pass	285032	15210	269822	0
svgs/oxygen-icons-5.113.0/scalable/actions/small/32x32/view-pim-news.svg	pass	161758	9907	151851	0
svgs/oxygen-icons-5.113.0/scalable/actions/small/32x32/view-pim-tasks-pending.svg	pass	300676	57468	243208	0
svgs/oxygen-icons-5.113.0/scalable/actions/small/32x32/view-pim-tasks.svg	pass	286075	47385	238690	0
svgs/oxygen-icons-5.113.0/scalable/actions/small/32x32/view-resource-calendar.svg	pass	197880	38562	159318	0
svgs/oxygen-icons-5.113.0/scalable/actions/small/32x32/view-stock-account.svg	pass	949813	374405	575408	0
svgs/oxygen-icons-5.113.0/scalable/actions/small/32x32/view-table-of-contents-ltr.svg	mismatch	37014	12364	24650	6
svgs/oxygen-icons-5.113.0/scalable/actions/small/32x32/view-table-of-contents-rtl.svg	mismatch	39480	12636	26844	5
svgs/oxygen-icons-5.113.0/scalable/actions/small/32x32/view-task-add.svg	pass	187374	23256	164118	0
svgs/oxygen-icons-5.113.0/scalable/actions/small/32x32/view-task-child-add.svg	pass	90266	15460	74806	0
svgs/oxygen-icons-5.113.0/scalable/actions/small/32x32/view-task-child.svg	pass	81097	11493	69604	0
svgs/oxygen-icons-5.113.0/scalable/actions/small/32x32/view-task.svg	pass	95451	18732	76719	0
svgs/oxygen-icons-5.113.0/scalable/actions/small/32x32/view-time-schedule-baselined-add.svg	mismatch	306450	140657	165793	37
svgs/oxygen-icons-5.113.0/scalable/actions/small/32x32/view-time-schedule-baselined-remove.svg	mismatch	324872	150506	174366	37
svgs/oxygen-icons-5.113.0/scalable/actions/small/32x32/view-time-schedule-baselined.svg	mismatch	331633	137024	194609	37
svgs/oxygen-icons-5.113.0/scalable/actions/small/32x32/view-time-schedule-calculus.svg	mismatch	116734	44774	71960	50
svgs/oxygen-icons-5.113.0/scalable/actions/small/32x32/view-time-schedule-child-insert.svg	mismatch	111345	13627	97718	34
svgs/oxygen-icons-5.113.0/scalable/actions/small/32x32/view-time-schedule-edit.svg	mismatch	74404	18024	56380	33
svgs/oxygen-icons-5.113.0/scalable/actions/small/32x32/view-time-schedule-insert.svg	mismatch	60531	12019	48512	35
svgs/oxygen-icons-5.113.0/scalable/actions/small/32x32/view-time-schedule.svg	mismatch	51772	8052	43720	35
svgs/oxygen-icons-5.113.0/scalable/actions/small/32x32/zoom-1-to-2.svg	pass	79363	12332	67031	0
svgs/oxygen-icons-5.113.0/scalable/actions/small/32x32/zoom-2-to-1.svg	pass	80144	12250	67894	0
svgs/oxygen-icons-5.113.0/scalable/actions/small/32x32/zoom-draw.svg	pass	29006	12007	16999	0
svgs/oxygen-icons-5.113.0/scalable/actions/small/32x32/zoom-fit-best.svg	pass	36353	6203	30150	0
svgs/oxygen-icons-5.113.0/scalable/actions/small/32x32/zoom-fit-height.svg	pass	36873	6209	30664	0
svgs/oxygen-icons-5.113.0/scalable/actions/small/32x32/zoom-fit-width.svg	pass	36364	6215	30149	0
svgs/oxygen-icons-5.113.0/scalable/actions/small/32x32/zoom-in.svg	pass	81123	13476	67647	0
svgs/oxygen-icons-5.113.0/scalable/actions/small/32x32/zoom-next.svg	pass	81454	11489	69965	0
svgs/oxygen-icons-5.113.0/scalable/actions/small/32x32/zoom-original.svg	pass	78534	12472	66062	0
svgs/oxygen-icons-5.113.0/scalable/actions/small/32x32/zoom-out.svg	pass	80494	12395	68099	0
svgs/oxygen-icons-5.113.0/scalable/actions/small/32x32/zoom-previous.svg	pass	78684	11447	67237	0
svgs/oxygen-icons-5.113.0/scalable/actions/small/32x32/zoom-select.svg	pass	31204	12256	18948	0
svgs/oxygen-icons-5.113.0/scalable/actions/small/48x48/address-book-new.svg	pass	3271732	2345046	926686	0
svgs/oxygen-icons-5.113.0/scalable/actions/small/48x48/align-horizontal-bottom-out.svg	pass	12684	4355	8329	0
svgs/oxygen-icons-5.113.0/scalable/actions/small/48x48/align-horizontal-center.svg	pass	9409	3874	5535	0
svgs/oxygen-icons-5.113.0/scalable/actions/small/48x48/align-horizontal-left-out.svg	pass	10288	4199	6089	0
svgs/oxygen-icons-5.113.0/scalable/actions/small/48x48/align-horizontal-left.svg	pass	8812	3357	5455	0
svgs/oxygen-icons-5.113.0/scalable/actions/small/48x48/align-horizontal-right-out.svg	pass	10266	4198	6068	0
svgs/oxygen-icons-5.113.0/scalable/actions/small/48x48/align-horizontal-right.svg	pass	8816	3350	5466	0
svgs/oxygen-icons-5.113.0/scalable/actions/small/48x48/align-horizontal-top-out.svg	pass	10514	4364	6150	0
svgs/oxygen-icons-5.113.0/scalable/actions/small/48x48/align-vertical-bottom.svg	pass	8768	3498	5270	0
svgs/oxygen-icons-5.113.0/scalable/actions/small/48x48/align-vertical-center.svg	pass	9687	4062	5625	0
svgs/oxygen-icons-5.113.0/scalable/actions/small/48x48/align-vertical-top.svg	pass	9011	3478	5533	0
svgs/oxygen-icons-5.113.0/scalable/actions/small/48x48/appointment-new.svg	pass	88949	37353	51596	0
svgs/oxygen-icons-5.113.0/scalable/actions/small/48x48/archive-extract.svg	pass	23150	9301	13849	0
svgs/oxygen-icons-5.113.0/scalable/actions/small/48x48/archive-insert-directory.svg	pass	197715	125684	72031	0
svgs/oxygen-icons-5.113.0/scalable/actions/small/48x48/archive-insert.svg	pass	225423	18181	207242	0
svgs/oxygen-icons-5.113.0/scalable/actions/small/48x48/archive-remove.svg	pass	42271	16217	26054	0
svgs/oxygen-icons-5.113.0/scalable/actions/small/48x48/bookmark-new.svg	pass	37035	11563	25472	0
svgs/oxygen-icons-5.113.0/scalable/actions/small/48x48/bookmark-toolbar.svg	pass	149885	23844	126041	0
svgs/oxygen-icons-5.113.0/scalable/actions/small/48x48/bookmarks-organize.svg	pass	801581	396451	405130	0
svgs/oxygen-icons-5.113.0/scalable/actions/small/48x48/call-start.svg	pass	43925	7868	36057	0
svgs/oxygen-icons-5.113.0/scalable/actions/small/48x48/call-stop.svg	pass	60369	7694	52675	0
svgs/oxygen-icons-5.113.0/scalable/actions/small/48x48/code-block.svg	pass	88787	33709	55078	0
svgs/oxygen-icons-5.113.0/scalable/actions/small/48x48/code-class.svg	pass	42811	10808	32003	0
svgs/oxygen-icons-5.113.0/scalable/actions/small/48x48/code-context.svg	pass	14785	7158	7627	0
svgs/oxygen-icons-5.113.0/scalable/actions/small/48x48/code-function.svg	pass	13905	6326	7579	0
svgs/oxygen-icons-5.113.0/scalable/actions/small/48x48/code-typedef.svg	pass	40442	7231	33211	0
svgs/oxygen-icons-5.113.0/scalable/actions/small/48x48/code-variable.svg	pass	12854	5525	7329	0
svgs/oxygen-icons-5.113.0/scalable/actions/small/48x48/color-picker-black.svg	pass	52623	22324	30299	0
svgs/oxygen-icons-5.113.0/scalable/actions/small/48x48/color-picker-grey.svg	pass	40775	21996	18779	0
svgs/oxygen-icons-5.113.0/scalable/actions/small/48x48/color-picker-white.svg	pass	40371	21617	18754	0
svgs/oxygen-icons-5.113.0/scalable/actions/small/48x48/color-picker.svg	pass	44712	18727	25985	0
svgs/oxygen-icons-5.113.0/scalable/actions/small/48x48/configure-toolbars.svg	pass	107088	36666	70422	0
svgs/oxygen-icons-5.113.0/scalable/actions/small/48x48/contact-new.svg	pass	275637	114276	161361	0
svgs/oxygen-icons-5.113.0/scalable/actions/small/48x48/debug-execute-from-cursor.svg	pass	203733	7385	196348	0
svgs/oxygen-icons-5.113.0/scalable/actions/small/48x48/debug-execute-to-cursor.svg	pass	196218	7415	188803	0
svgs/oxygen-icons-5.113.0/scalable/actions/small/48x48/debug-run-cursor.svg	pass	396317	44428	351889	0
svgs/oxygen-icons-5.113.0/scalable/actions/small/48x48/debug-run.svg	pass	395028	42763	352265	0
svgs/oxygen-icons-5.113.0/scalable/actions/small/48x48/debug-step-instruction.svg	pass	45661	9568	36093	0
svgs/oxygen-icons-5.113.0/scalable/actions/small/48x48/debug-step-into-instruction.svg	pass	47222	10184	37038	0
svgs/oxygen-icons-5.113.0/scalable/actions/small/48x48/debug-step-into.svg	pass	46773	9993	36780	0
svgs/oxygen-icons-5.113.0/scalable/actions/small/48x48/debug-step-out.svg	pass	45755	9465	36290	0
svgs/oxygen-icons-5.113.0/scalable/actions/small/48x48/debug-step-over.svg	pass	45226	9384	35842	0
svgs/oxygen-icons-5.113.0/scalable/actions/small/48x48/document-edit-decrypt-verify.svg	pass	713955	126875	587080	0
svgs/oxygen-icons-5.113.0/scalable/actions/small/48x48/document-edit-decrypt.svg	pass	747872	155251	592621	0
svgs/oxygen-icons-5.113.0/scalable/actions/small/48x48/document-edit-encrypt.svg	pass	731067	158626	572441	0
svgs/oxygen-icons-5.113.0/scalable/actions/small/48x48/document-edit-sign-encrypt.svg	pass	1241121	140837	1100284	0
svgs/oxygen-icons-5.113.0/scalable/actions/small/48x48/document-edit-sign.svg	pass	1148199	255910	892289	0
svgs/oxygen-icons-5.113.0/scalable/actions/small/48x48/document-edit-verify.svg	pass	893403	255095	638308	0
svgs/oxygen-icons-5.113.0/scalable/actions/small/48x48/document-edit.svg	pass	533456	17518	515938	0
svgs/oxygen-icons-5.113.0/scalable/actions/small/48x48/document-encrypted.svg	pass	513658	24110	489548	0
svgs/oxygen-icons-5.113.0/scalable/actions/small/48x48/document-export-table.svg	pass	135589	17913	117676	0
svgs/oxygen-icons-5.113.0/scalable/actions/small/48x48/document-export.svg	pass	57218	11142	46076	0
svgs/oxygen-icons-5.113.0/scalable/actions/small/48x48/document-import.svg	pass	57578	12332	45246	0
svgs/oxygen-icons-5.113.0/scalable/actions/small/48x48/document-new.svg	pass	19622	8110	11512	0
svgs/oxygen-icons-5.113.0/scalable/actions/small/48x48/document-open-folder.svg	pass	378517	128978	249539	0
svgs/oxygen-icons-5.113.0/scalable/actions/small/48x48/document-open-recent.svg	pass	18803	9371	9432	0
svgs/oxygen-icons-5.113.0/scalable/actions/small/48x48/document-open-remote.svg	pass	794116	457315	336801	0
svgs/oxygen-icons-5.113.0/scalable/actions/small/48x48/document-open.svg	pass	380283	128978	251305	0
svgs/oxygen-icons-5.113.0/scalable/actions/small/48x48/document-save-all.svg	pass	2360055	1488794	871261	0
svgs/oxygen-icons-5.113.0/scalable/actions/small/48x48/document-save-as.svg	pass	1189807	760457	429350	0
svgs/oxygen-icons-5.113.0/scalable/actions/small/48x48/document-save.svg	pass	1116723	747430	369293	0
svgs/oxygen-icons-5.113.0/scalable/actions/small/48x48/document-share.svg	pass	23947	9525	14422	0
svgs/oxygen-icons-5.113.0/scalable/actions/small/48x48/documentation.svg	pass	331099	101990	229109	0
svgs/oxygen-icons-5.113.0/scalable/actions/small/48x48/download-later.svg	pass	98018	17500	80518	0
svgs/oxygen-icons-5.113.0/scalable/actions/small/48x48/download.svg	pass	665650	345940	319710	0
svgs/oxygen-icons-5.113.0/scalable/actions/small/48x48/draw-bezier-curves.svg	pass	16638	5805	10833	0
svgs/oxygen-icons-5.113.0/scalable/actions/small/48x48/draw-halfcircle1.svg	pass	5977	1830	4147	0
svgs/oxygen-icons-5.113.0/scalable/actions/small/48x48/draw-halfcircle2.svg	pass	6013	1876	4137	0
svgs/oxygen-icons-5.113.0/scalable/actions/small/48x48/draw-halfcircle3.svg	pass	6009	1881	4128	0
svgs/oxygen-icons-5.113.0/scalable/actions/small/48x48/draw-halfcircle4.svg	pass	5974	1837	4137	0
svgs/oxygen-icons-5.113.0/scalable/actions/small/48x48/draw-path.svg	pass	41896	11848	30048	0
svgs/oxygen-icons-5.113.0/scalable/actions/small/48x48/draw-polyline.svg	pass	36650	2080	34570	0
svgs/oxygen-icons-5.113.0/scalable/actions/small/48x48/draw-rectangle.svg	pass	35242	1916	33326	0
svgs/oxygen-icons-5.113.0/scalable/actions/small/48x48/draw-spiral.svg	pass	11374	3244	8130	0
svgs/oxygen-icons-5.113.0/scalable/actions/small/48x48/draw-square-inverted-corners.svg	pass	6742	2089	4653	0
svgs/oxygen-icons-5.113.0/scalable/actions/small/48x48/draw-text.svg	pass	7113	1393	5720	0
svgs/oxygen-icons-5.113.0/scalable/actions/small/48x48/draw-triangle.svg	pass	5900	1902	3998	0
svgs/oxygen-icons-5.113.0/scalable/actions/small/48x48/draw-triangle1.svg	pass	35100	1959	33141	0
svgs/oxygen-icons-5.113.0/scalable/actions/small/48x48/draw-triangle2.svg	pass	5900	1900	4000	0
svgs/oxygen-icons-5.113.0/scalable/actions/small/48x48/draw-triangle3.svg	pass	5974	1900	4074	0
svgs/oxygen-icons-5.113.0/scalable/actions/small/48x48/draw-triangle4.svg	pass	5915	1910	4005	0
svgs/oxygen-icons-5.113.0/scalable/actions/small/48x48/edit-clear-list.svg	pass	204705	14992	189713	0
svgs/oxygen-icons-5.113.0/scalable/actions/small/48x48/edit-copy.svg	pass	136218	8662	127556	0
svgs/oxygen-icons-5.113.0/scalable/actions/small/48x48/edit-find-project.svg	pass	283102	64946	218156	1
svgs/oxygen-icons-5.113.0/scalable/actions/small/48x48/edit-guides.svg	pass	26111	3934	22177	0
svgs/oxygen-icons-5.113.0/scalable/actions/small/48x48/edit-image-face-add.svg	pass	190279	82241	108038	0
svgs/oxygen-icons-5.113.0/scalable/actions/small/48x48/edit-image-face-detect.svg	pass	19733	3277	16456	0
svgs/oxygen-icons-5.113.0/scalable/actions/small/48x48/edit-image-face-recognize.svg	pass	138840	42293	96547	0
svgs/oxygen-icons-5.113.0/scalable/actions/small/48x48/edit-image-face-show.svg	mismatch	679255	118625	560630	173
svgs/oxygen-icons-5.113.0/scalable/actions/small/48x48/edit-node.svg	pass	48131	4004	44127	0
svgs/oxygen-icons-5.113.0/scalable/actions/small/48x48/edit-paste.svg	pass	114088	16468	97620	0
svgs/oxygen-icons-5.113.0/scalable/actions/small/48x48/edit-select-all.svg	pass	97803	59589	38214	0
svgs/oxygen-icons-5.113.0/scalable/actions/small/48x48/edit-select-none.svg	pass	116006	68979	47027	0
svgs/oxygen-icons-5.113.0/scalable/actions/small/48x48/edit-select.svg	pass	25172	2717	22455	0
svgs/oxygen-icons-5.113.0/scalable/actions/small/48x48/edit-table-cell-merge.svg	pass	65005	8355	56650	0
svgs/oxygen-icons-5.113.0/scalable/actions/small/48x48/edit-table-cell-split.svg	pass	65464	8596	56868	0
svgs/oxygen-icons-5.113.0/scalable/actions/small/48x48/edit-table-delete-column.svg	pass	326935	19521	307414	0
svgs/oxygen-icons-5.113.0/scalable/actions/small/48x48/edit-table-delete-row.svg	pass	366379	20806	345573	0
svgs/oxygen-icons-5.113.0/scalable/actions/small/48x48/edit-table-insert-column-left.svg	pass	71903	13460	58443	0
svgs/oxygen-icons-5.113.0/scalable/actions/small/48x48/edit-table-insert-column-right.svg	pass	73300	13605	59695	0
svgs/oxygen-icons-5.113.0/scalable/actions/small/48x48/edit-table-insert-row-above.svg	pass	56518	13942	42576	0
svgs/oxygen-icons-5.113.0/scalable/actions/small/48x48/edit-table-insert-row-below.svg	pass	56512	13937	42575	0
svgs/oxygen-icons-5.113.0/scalable/actions/small/48x48/edit-text-frame-update.svg	pass	23572	4966	18606	0
svgs/oxygen-icons-5.113.0/scalable/actions/small/48x48/edit-web-search.svg	pass	828293	395334	432959	1
svgs/oxygen-icons-5.113.0/scalable/actions/small/48x48/flag-blue.svg	pass	235670	42431	193239	0
svgs/oxygen-icons-5.113.0/scalable/actions/small/48x48/folder-new.svg	pass	197715	125684	72031	0
svgs/oxygen-icons-5.113.0/scalable/actions/small/48x48/folder-sync.svg	pass	147903	125708	22195	0
svgs/oxygen-icons-5.113.0/scalable/actions/small/48x48/format-add-node.svg	pass	26560	11790	14770	0
svgs/oxygen-icons-5.113.0/scalable/actions/small/48x48/format-break-node.svg	pass	31394	5892	25502	0
svgs/oxygen-icons-5.113.0/scalable/actions/small/48x48/format-connect-node.svg	pass	34009	7497	26512	0
svgs/oxygen-icons-5.113.0/scalable/actions/small/48x48/format-disconnect-node.svg	pass	32796	7206	25590	0
svgs/oxygen-icons-5.113.0/scalable/actions/small/48x48/format-join-node.svg	pass	30008	5886	24122	0
svgs/oxygen-icons-5.113.0/scalable/actions/small/48x48/format-remove-node.svg	pass	149090	11821	137269	0
svgs/oxygen-icons-5.113.0/scalable/actions/small/48x48/format-text-color.svg	pass	86301	4012	82289	0
svgs/oxygen-icons-5.113.0/scalable/actions/small/48x48/games-achievements.svg	pass	636182	139615	496567	0
svgs/oxygen-icons-5.113.0/scalable/actions/small/48x48/games-highscores.svg	pass	290810	144538	146272	1
svgs/oxygen-icons-5.113.0/scalable/actions/small/48x48/go-first-view-page.svg	pass	151456	24684	126772	0
svgs/oxygen-icons-5.113.0/scalable/actions/small/48x48/go-first-view.svg	pass	45221	11668	33553	0
svgs/oxygen-icons-5.113.0/scalable/actions/small/48x48/go-jump-declaration.svg	pass	68602	16018	52584	0
svgs/oxygen-icons-5.113.0/scalable/actions/small/48x48/go-jump-definition.svg	pass	107872	8456	99416	0
svgs/oxygen-icons-5.113.0/scalable/actions/small/48x48/go-jump-locationbar.svg	pass	701923	341506	360417	0
svgs/oxygen-icons-5.113.0/scalable/actions/small/48x48/go-last-view-page.svg	pass	151635	24640	126995	0
svgs/oxygen-icons-5.113.0/scalable/actions/small/48x48/go-last-view.svg	pass	38660	12139	26521	0
svgs/oxygen-icons-5.113.0/scalable/actions/small/48x48/go-next-context.svg	pass	18264	8356	9908	0
svgs/oxygen-icons-5.113.0/scalable/actions/small/48x48/go-next-use.svg	pass	95618	8466	87152	0
svgs/oxygen-icons-5.113.0/scalable/actions/small/48x48/go-next-view-page.svg	pass	86074	17592	68482	0
svgs/oxygen-icons-5.113.0/scalable/actions/small/48x48/go-next-view.svg	pass	37905	6274	31631	0
svgs/oxygen-icons-5.113.0/scalable/actions/small/48x48/go-previous-context.svg	pass	16871	7571	9300	0
svgs/oxygen-icons-5.113.0/scalable/actions/small/48x48/go-previous-use.svg	pass	98039	8459	89580	0
svgs/oxygen-icons-5.113.0/scalable/actions/small/48x48/go-previous-view-page.svg	pass	85332	17559	67773	0
svgs/oxygen-icons-5.113.0/scalable/actions/small/48x48/go-previous-view.svg	pass	39424	5792	33632	0
svgs/oxygen-icons-5.113.0/scalable/actions/small/48x48/help-about.svg	pass	43883	10915	32968	3
svgs/oxygen-icons-5.113.0/scalable/actions/small/48x48/help-contents.svg	pass	1195019	575802	619217	0
svgs/oxygen-icons-5.113.0/scalable/actions/small/48x48/help-contextual.svg	pass	420047	186839	233208	3
svgs/oxygen-icons-5.113.0/scalable/actions/small/48x48/help-donate.svg	pass	162185	23426	138759	0
svgs/oxygen-icons-5.113.0/scalable/actions/small/48x48/help-feedback.svg	pass	54614	16392	38222	3
svgs/oxygen-icons-5.113.0/scalable/actions/small/48x48/im-aim.svg	pass	64341	20850	43491	0
svgs/oxygen-icons-5.113.0/scalable/actions/small/48x48/im-facebook.svg	pass	46025	10451	35574	0
svgs/oxygen-icons-5.113.0/scalable/actions/small/48x48/im-gadugadu.svg	pass	83483	16451	67032	0
svgs/oxygen-icons-5.113.0/scalable/actions/small/48x48/im-google-talk.svg	pass	94322	18633	75689	0
svgs/oxygen-icons-5.113.0/scalable/actions/small/48x48/im-google.svg	mismatch	40891	15989	24902	16
svgs/oxygen-icons-5.113.0/scalable/actions/small/48x48/im-icq.svg	pass	77393	30131	47262	0
svgs/oxygen-icons-5.113.0/scalable/actions/small/48x48/im-identi.ca.svg	pass	112082	31023	81059	0
svgs/oxygen-icons-5.113.0/scalable/actions/small/48x48/im-jabber.svg	pass	64201	22324	41877	0
svgs/oxygen-icons-5.113.0/scalable/actions/small/48x48/im-msn.svg	pass	75847	32219	43628	0
svgs/oxygen-icons-5.113.0/scalable/actions/small/48x48/im-qq.svg	pass	62607	24886	37721	0
svgs/oxygen-icons-5.113.0/scalable/actions/small/48x48/im-skype.svg	pass	43925	7868	36057	0
svgs/oxygen-icons-5.113.0/scalable/actions/small/48x48/im-twitter.svg	pass	47949	11513	36436	0
svgs/oxygen-icons-5.113.0/scalable/actions/small/48x48/im-yahoo.svg	pass	93419	27209	66210	4
svgs/oxygen-icons-5.113.0/scalable/actions/small/48x48/list-resource-add.svg	pass	201518	146054	55464	0
svgs/oxygen-icons-5.113.0/scalable/actions/small/48x48/mail-encrypted-full.svg	pass	462320	315814	146506	0
svgs/oxygen-icons-5.113.0/scalable/actions/small/48x48/mail-encrypted-part.svg	pass	612664	387134	225530	0
svgs/oxygen-icons-5.113.0/scalable/actions/small/48x48/mail-encrypted.svg	pass	435111	315109	120002	0
svgs/oxygen-icons-5.113.0/scalable/actions/small/48x48/mail-forward.svg	pass	323518	130004	193514	0
svgs/oxygen-icons-5.113.0/scalable/actions/small/48x48/mail-forwarded-replied.svg	pass	700572	279515	421057	0
svgs/oxygen-icons-5.113.0/scalable/actions/small/48x48/mail-forwarded.svg	pass	633621	274222	359399	0
svgs/oxygen-icons-5.113.0/scalable/actions/small/48x48/mail-invitation.svg	pass	27541	13284	14257	3
svgs/oxygen-icons-5.113.0/scalable/actions/small/48x48/mail-mark-important.svg	pass	127308	8756	118552	0
svgs/oxygen-icons-5.113.0/scalable/actions/small/48x48/mail-mark-junk.svg	pass	215946	18750	197196	0
svgs/oxygen-icons-5.113.0/scalable/actions/small/48x48/mail-mark-notjunk.svg	pass	20851	9102	11749	0
svgs/oxygen-icons-5.113.0/scalable/actions/small/48x48/mail-mark-read.svg	pass	513392	268591	244801	0
svgs/oxygen-icons-5.113.0/scalable/actions/small/48x48/mail-mark-unread-new.svg	pass	75764	6840	68924	0
svgs/oxygen-icons-5.113.0/scalable/actions/small/48x48/mail-mark-unread.svg	pass	65052	4092	60960	0
svgs/oxygen-icons-5.113.0/scalable/actions/small/48x48/mail-meeting-request-reply.svg	pass	67597	5356	62241	0
svgs/oxygen-icons-5.113.0/scalable/actions/small/48x48/mail-message-new-list.svg	pass	365002	175058	189944	0
svgs/oxygen-icons-5.113.0/scalable/actions/small/48x48/mail-message-new.svg	pass	315289	173104	142185	0
svgs/oxygen-icons-5.113.0/scalable/actions/small/48x48/mail-queue.svg	pass	332507	125239	207268	0
svgs/oxygen-icons-5.113.0/scalable/actions/small/48x48/mail-replied.svg	pass	695320	273702	421618	0
svgs/oxygen-icons-5.113.0/scalable/actions/small/48x48/mail-reply-all.svg	pass	72153	9646	62507	0
svgs/oxygen-icons-5.113.0/scalable/actions/small/48x48/mail-reply-custom-all.svg	pass	69646	8465	61181	0
svgs/oxygen-icons-5.113.0/scalable/actions/small/48x48/mail-reply-list.svg	pass	83592	16449	67143	0
svgs/oxygen-icons-5.113.0/scalable/actions/small/48x48/mail-reply-sender.svg	pass	78589	9174	69415	0
svgs/oxygen-icons-5.113.0/scalable/actions/small/48x48/mail-send.svg	pass	724848	126580	598268	0
svgs/oxygen-icons-5.113.0/scalable/actions/small/48x48/mail-signature-unknown.svg	pass	301718	189757	111961	1
svgs/oxygen-icons-5.113.0/scalable/actions/small/48x48/mail-signed-full.svg	pass	282022	180487	101535	0
svgs/oxygen-icons-5.113.0/scalable/actions/small/48x48/mail-signed-part.svg	pass	282661	180835	101826	0
svgs/oxygen-icons-5.113.0/scalable/actions/small/48x48/mail-signed-verified.svg	pass	294684	188650	106034	1
svgs/oxygen-icons-5.113.0/scalable/actions/small/48x48/mail-signed.svg	pass	281065	179420	101645	1
svgs/oxygen-icons-5.113.0/scalable/actions/small/48x48/mail-tagged.svg	pass	287004	183047	103957	1
svgs/oxygen-icons-5.113.0/scalable/actions/small/48x48/measure.svg	pass	13512	4468	9044	0
svgs/oxygen-icons-5.113.0/scalable/actions/small/48x48/meeting-participant-no-response.svg	pass	282971	149439	133532	0
svgs/oxygen-icons-5.113.0/scalable/actions/small/48x48/meeting-participant-request-response.svg	pass	282725	149527	133198	0
svgs/oxygen-icons-5.113.0/scalable/actions/small/48x48/merge.svg	pass	337753	5113	332640	0
svgs/oxygen-icons-5.113.0/scalable/actions/small/48x48/milestone.svg	pass	407347	142472	264875	0
svgs/oxygen-icons-5.113.0/scalable/actions/small/48x48/news-subscribe.svg	pass	424464	16748	407716	0
svgs/oxygen-icons-5.113.0/scalable/actions/small/48x48/news-unsubscribe.svg	pass	394502	19461	375041	0
svgs/oxygen-icons-5.113.0/scalable/actions/small/48x48/object-flip-horizontal.svg	pass	70699	6320	64379	0
svgs/oxygen-icons-5.113.0/scalable/actions/small/48x48/object-flip-vertical.svg	pass	71057	6051	65006	0
svgs/oxygen-icons-5.113.0/scalable/actions/small/48x48/office-chart-area-focus-peak-node.svg	pass	14942	7348	7594	0
svgs/oxygen-icons-5.113.0/scalable/actions/small/48x48/office-chart-area-percentage.svg	pass	96182	14326	81856	0
svgs/oxygen-icons-5.113.0/scalable/actions/small/48x48/office-chart-area-stacked.svg	pass	11860	5977	5883	0
svgs/oxygen-icons-5.113.0/scalable/actions/small/48x48/office-chart-area.svg	pass	12492	6554	5938	0
svgs/oxygen-icons-5.113.0/scalable/actions/small/48x48/office-chart-bar-percentage.svg	pass	103815	13299	90516	0
svgs/oxygen-icons-5.113.0/scalable/actions/small/48x48/office-chart-bar-stacked.svg	pass	28361	12075	16286	0
svgs/oxygen-icons-5.113.0/scalable/actions/small/48x48/office-chart-bar.svg	pass	76709	7305	69404	0
svgs/oxygen-icons-5.113.0/scalable/actions/small/48x48/office-chart-line-percentage.svg	pass	80784	5452	75332	0
svgs/oxygen-icons-5.113.0/scalable/actions/small/48x48/office-chart-line-stacked.svg	pass	70578	3691	66887	0
svgs/oxygen-icons-5.113.0/scalable/actions/small/48x48/office-chart-line.svg	pass	70570	3692	66878	0
svgs/oxygen-icons-5.113.0/scalable/actions/small/48x48/office-chart-pie.svg	pass	31725	16786	14939	0
svgs/oxygen-icons-5.113.0/scalable/actions/small/48x48/office-chart-polar-stacked.svg	pass	76345	6069	70276	0
svgs/oxygen-icons-5.113.0/scalable/actions/small/48x48/office-chart-polar.svg	pass	70618	3793	66825	0
svgs/oxygen-icons-5.113.0/scalable/actions/small/48x48/office-chart-ring.svg	pass	32064	11706	20358	0
svgs/oxygen-icons-5.113.0/scalable/actions/small/48x48/office-chart-scatter.svg	pass	76237	6610	69627	0
svgs/oxygen-icons-5.113.0/scalable/actions/small/48x48/page-zoom.svg	pass	43072	17849	25223	0
svgs/oxygen-icons-5.113.0/scalable/actions/small/48x48/preferences-activities.svg	pass	521031	12993	508038	0
svgs/oxygen-icons-5.113.0/scalable/actions/small/48x48/preflight-verifier.svg	pass	706367	450664	255703	0
svgs/oxygen-icons-5.113.0/scalable/actions/small/48x48/project-development-close-all.svg	pass	183844	24693	159151	0
svgs/oxygen-icons-5.113.0/scalable/actions/small/48x48/project-development-close.svg	pass	174735	20121	154614	0
svgs/oxygen-icons-5.113.0/scalable/actions/small/48x48/project-development-new-template.svg	pass	207962	14245	193717	0
svgs/oxygen-icons-5.113.0/scalable/actions/small/48x48/project-development.svg	pass	143327	10552	132775	0
svgs/oxygen-icons-5.113.0/scalable/actions/small/48x48/project-open.svg	pass	510700	232835	277865	0
svgs/oxygen-icons-5.113.0/scalable/actions/small/48x48/quickopen-class.svg	pass	80860	21872	58988	0
svgs/oxygen-icons-5.113.0/scalable/actions/small/48x48/quickopen-file.svg	pass	246854	18275	228579	0
svgs/oxygen-icons-5.113.0/scalable/actions/small/48x48/quickopen-function.svg	pass	92708	17880	74828	0
svgs/oxygen-icons-5.113.0/scalable/actions/small/48x48/quickopen.svg	pass	41355	11696	29659	0
svgs/oxygen-icons-5.113.0/scalable/actions/small/48x48/resource-calendar-child-insert.svg	pass	67399	18142	49257	0
svgs/oxygen-icons-5.113.0/scalable/actions/small/48x48/resource-calendar-child.svg	pass	58051	14025	44026	0
svgs/oxygen-icons-5.113.0/scalable/actions/small/48x48/resource-calendar-insert.svg	pass	296557	44685	251872	0
svgs/oxygen-icons-5.113.0/scalable/actions/small/48x48/resource-group-new.svg	pass	209664	151268	58396	0
svgs/oxygen-icons-5.113.0/scalable/actions/small/48x48/run-build-clean.svg	pass	267672	65099	202573	0
svgs/oxygen-icons-5.113.0/scalable/actions/small/48x48/run-build-configure.svg	pass	298449	64486	233963	0
svgs/oxygen-icons-5.113.0/scalable/actions/small/48x48/run-build-file.svg	pass	231668	42806	188862	0
svgs/oxygen-icons-5.113.0/scalable/actions/small/48x48/run-build-install-root.svg	pass	236504	47530	188974	0
svgs/oxygen-icons-5.113.0/scalable/actions/small/48x48/run-build-install.svg	pass	338486	48442	290044	0
svgs/oxygen-icons-5.113.0/scalable/actions/small/48x48/run-build-prune.svg	pass	301958	90028	211930	0
svgs/oxygen-icons-5.113.0/scalable/actions/small/48x48/run-build.svg	pass	306950	39564	267386	0
svgs/oxygen-icons-5.113.0/scalable/actions/small/48x48/snap-extension.svg	pass	26495	7127	19368	0
svgs/oxygen-icons-5.113.0/scalable/actions/small/48x48/snap-guideline.svg	pass	29095	8198	20897	0
svgs/oxygen-icons-5.113.0/scalable/actions/small/48x48/snap-intersection.svg	pass	22564	4520	18044	0
svgs/oxygen-icons-5.113.0/scalable/actions/small/48x48/snap-node.svg	pass	22283	4666	17617	0
svgs/oxygen-icons-5.113.0/scalable/actions/small/48x48/snap-orthogonal.svg	pass	26056	4933	21123	0
svgs/oxygen-icons-5.113.0/scalable/actions/small/48x48/split.svg	pass	346498	14407	332091	0
svgs/oxygen-icons-5.113.0/scalable/actions/small/48x48/story-editor.svg	pass	38404	17536	20868	0
svgs/oxygen-icons-5.113.0/scalable/actions/small/48x48/stroke-cap-butt.svg	pass	7965	3032	4933	0
svgs/oxygen-icons-5.113.0/scalable/actions/small/48x48/stroke-cap-round.svg	pass	7862	2990	4872	0
svgs/oxygen-icons-5.113.0/scalable/actions/small/48x48/stroke-cap-square.svg	pass	8101	3139	4962	0
svgs/oxygen-icons-5.113.0/scalable/actions/small/48x48/stroke-join-bevel.svg	pass	13422	3580	9842	0
svgs/oxygen-icons-5.113.0/scalable/actions/small/48x48/stroke-join-miter.svg	pass	10202	3521	6681	0
svgs/oxygen-icons-5.113.0/scalable/actions/small/48x48/stroke-join-round.svg	pass	13649	3730	9919	0
svgs/oxygen-icons-5.113.0/scalable/actions/small/48x48/tab-new-background.svg	pass	47376	6140	41236	0
svgs/oxygen-icons-5.113.0/scalable/actions/small/48x48/taxes-finances.svg	pass	475222	69924	405298	0
svgs/oxygen-icons-5.113.0/scalable/actions/small/48x48/text-field.svg	pass	7020	2222	4798	0
svgs/oxygen-icons-5.113.0/scalable/actions/small/48x48/text-frame-link.svg	pass	28252	10871	17381	0
svgs/oxygen-icons-5.113.0/scalable/actions/small/48x48/text-frame-unlink.svg	pass	18178	6524	11654	0
svgs/oxygen-icons-5.113.0/scalable/actions/small/48x48/tool-animator.svg	pass	47079	16088	30991	0
svgs/oxygen-icons-5.113.0/scalable/actions/small/48x48/tools-check-spelling.svg	pass	25473	11986	13487	0
svgs/oxygen-icons-5.113.0/scalable/actions/small/48x48/tools-media-optical-burn-image.svg	pass	77854	41980	35874	0
svgs/oxygen-icons-5.113.0/scalable/actions/small/48x48/tools-media-optical-burn.svg	pass	74399	43138	31261	0
svgs/oxygen-icons-5.113.0/scalable/actions/small/48x48/tools-media-optical-copy.svg	pass	53777	28875	24902	0
svgs/oxygen-icons-5.113.0/scalable/actions/small/48x48/tools-media-optical-erase.svg	pass	86647	24191	62456	0
svgs/oxygen-icons-5.113.0/scalable/actions/small/48x48/tools-media-optical-format.svg	pass	61143	32884	28259	0
svgs/oxygen-icons-5.113.0/scalable/actions/small/48x48/tools-rip-audio-cd.svg	pass	78780	45725	33055	0
svgs/oxygen-icons-5.113.0/scalable/actions/small/48x48/tools-rip-video-cd.svg	pass	102047	35601	66446	0
svgs/oxygen-icons-5.113.0/scalable/actions/small/48x48/tools-rip-video-dvd.svg	pass	364186	147969	216217	0
svgs/oxygen-icons-5.113.0/scalable/actions/small/48x48/transform-crop-and-resize.svg	pass	194426	26579	167847	0
svgs/oxygen-icons-5.113.0/scalable/actions/small/48x48/transform-crop.svg	pass	40883	15616	25267	0
svgs/oxygen-icons-5.113.0/scalable/actions/small/48x48/transform-rotate.svg	pass	17889	4760	13129	0
svgs/oxygen-icons-5.113.0/scalable/actions/small/48x48/transform-scale.svg	pass	202530	23572	178958	0
svgs/oxygen-icons-5.113.0/scalable/actions/small/48x48/transform-shear-down.svg	pass	10391	4222	6169	0
svgs/oxygen-icons-5.113.0/scalable/actions/small/48x48/transform-shear-left.svg	pass	10673	4197	6476	0
svgs/oxygen-icons-5.113.0/scalable/actions/small/48x48/transform-shear-right.svg	pass	10083	4196	5887	0
svgs/oxygen-icons-5.113.0/scalable/actions/small/48x48/transform-shear-up.svg	pass	10386	4213	6173	0
svgs/oxygen-icons-5.113.0/scalable/actions/small/48x48/view-bank-account-checking.svg	pass	688974	129117	559857	0
svgs/oxygen-icons-5.113.0/scalable/actions/small/48x48/view-bank-account-savings.svg	pass	322026	191094	130932	0
svgs/oxygen-icons-5.113.0/scalable/actions/small/48x48/view-bank-account.svg	pass	273521	118339	155182	0
svgs/oxygen-icons-5.113.0/scalable/actions/small/48x48/view-bank.svg	pass	261302	21740	239562	0
svgs/oxygen-icons-5.113.0/scalable/actions/small/48x48/view-barcode-add.svg	pass	356366	9995	346371	0
svgs/oxygen-icons-5.113.0/scalable/actions/small/48x48/view-barcode.svg	pass	71859	3830	68029	0
svgs/oxygen-icons-5.113.0/scalable/actions/small/48x48/view-calendar-agenda.svg	pass	163079	20591	142488	0
svgs/oxygen-icons-5.113.0/scalable/actions/small/48x48/view-calendar-birthday.svg	pass	61865	29140	32725	0
svgs/oxygen-icons-5.113.0/scalable/actions/small/48x48/view-calendar-holiday.svg	pass	51453	18215	33238	0
svgs/oxygen-icons-5.113.0/scalable/actions/small/48x48/view-calendar-journal.svg	pass	405928	150724	255204	0
svgs/oxygen-icons-5.113.0/scalable/actions/small/48x48/view-calendar-list.svg	pass	89552	14391	75161	1
svgs/oxygen-icons-5.113.0/scalable/actions/small/48x48/view-calendar-special-occasion.svg	pass	86671	49470	37201	0
svgs/oxygen-icons-5.113.0/scalable/actions/small/48x48/view-calendar-tasks.svg	pass	92290	15557	76733	0
svgs/oxygen-icons-5.113.0/scalable/actions/small/48x48/view-calendar-time-spent.svg	pass	136104	29016	107088	0
svgs/oxygen-icons-5.113.0/scalable/actions/small/48x48/view-calendar-timeline.svg	pass	63520	13956	49564	0
svgs/oxygen-icons-5.113.0/scalable/actions/small/48x48/view-calendar-wedding-anniversary.svg	pass	94135	20488	73647	0
svgs/oxygen-icons-5.113.0/scalable/actions/small/48x48/view-calendar-whatsnext.svg	pass	858071	366333	491738	0
svgs/oxygen-icons-5.113.0/scalable/actions/small/48x48/view-calendar.svg	pass	86274	36363	49911	0
svgs/oxygen-icons-5.113.0/scalable/actions/small/48x48/view-catalog.svg	pass	90763	43686	47077	0
svgs/oxygen-icons-5.113.0/scalable/actions/small/48x48/view-certificate-add.svg	pass	446905	125326	321579	0
svgs/oxygen-icons-5.113.0/scalable/actions/small/48x48/view-certificate-export-secret.svg	pass	466150	42935	423215	0
svgs/oxygen-icons-5.113.0/scalable/actions/small/48x48/view-certificate-export-server.svg	pass	1136385	460251	676134	1
svgs/oxygen-icons-5.113.0/scalable/actions/small/48x48/view-certificate-export.svg	pass	436686	125002	311684	0
svgs/oxygen-icons-5.113.0/scalable/actions/small/48x48/view-certificate-import.svg	pass	324399	123329	201070	0
svgs/oxygen-icons-5.113.0/scalable/actions/small/48x48/view-certificate-server-configure.svg	pass	1356732	577514	779218	0
svgs/oxygen-icons-5.113.0/scalable/actions/small/48x48/view-certificate-sign.svg	pass	469252	139886	329366	0
svgs/oxygen-icons-5.113.0/scalable/actions/small/48x48/view-certificate.svg	pass	291554	120519	171035	0
svgs/oxygen-icons-5.113.0/scalable/actions/small/48x48/view-choose.svg	pass	79983	7596	72387	0
svgs/oxygen-icons-5.113.0/scalable/actions/small/48x48/view-close.svg	pass	43047	3382	39665	0
svgs/oxygen-icons-5.113.0/scalable/actions/small/48x48/view-conversation-balloon.svg	pass	40311	14735	25576	0
svgs/oxygen-icons-5.113.0/scalable/actions/small/48x48/view-credit-card-account.svg	pass	325401	196372	129029	0
svgs/oxygen-icons-5.113.0/scalable/actions/small/48x48/view-currency-list.svg	pass	408472	14921	393551	0
svgs/oxygen-icons-5.113.0/scalable/actions/small/48x48/view-documents-finances.svg	pass	570402	240722	329680	1
svgs/oxygen-icons-5.113.0/scalable/actions/small/48x48/view-expenses-categories.svg	pass	371877	151577	220300	0
svgs/oxygen-icons-5.113.0/scalable/actions/small/48x48/view-file-columns.svg	pass	42822	4418	38404	0
svgs/oxygen-icons-5.113.0/scalable/actions/small/48x48/view-financial-categories.svg	pass	351946	150960	200986	0
svgs/oxygen-icons-5.113.0/scalable/actions/small/48x48/view-financial-forecast.svg	pass	18400	8812	9588	0
svgs/oxygen-icons-5.113.0/scalable/actions/small/48x48/view-financial-list.svg	pass	216060	88398	127662	0
svgs/oxygen-icons-5.113.0/scalable/actions/small/48x48/view-financial-payment-mode.svg	pass	615902	198853	417049	0
svgs/oxygen-icons-5.113.0/scalable/actions/small/48x48/view-financial-transfer.svg	pass	532184	67688	464496	0
svgs/oxygen-icons-5.113.0/scalable/actions/small/48x48/view-form-action.svg	pass	234231	19024	215207	0
svgs/oxygen-icons-5.113.0/scalable/actions/small/48x48/view-form-table.svg	pass	219097	8619	210478	0
svgs/oxygen-icons-5.113.0/scalable/actions/small/48x48/view-form.svg	pass	125324	13012	112312	0
svgs/oxygen-icons-5.113.0/scalable/actions/small/48x48/view-fullscreen.svg	pass	260004	4297	255707	0
svgs/oxygen-icons-5.113.0/scalable/actions/small/48x48/view-grid.svg	pass	27490	13163	14327	0
svgs/oxygen-icons-5.113.0/scalable/actions/small/48x48/view-group.svg	pass	99113	19807	79306	0
svgs/oxygen-icons-5.113.0/scalable/actions/small/48x48/view-income-categories.svg	pass	197367	130700	66667	0
svgs/oxygen-icons-5.113.0/scalable/actions/small/48x48/view-investment-account.svg	pass	1679572	745813	933759	0
svgs/oxygen-icons-5.113.0/scalable/actions/small/48x48/view-investment.svg	pass	552599	99339	453260	0
svgs/oxygen-icons-5.113.0/scalable/actions/small/48x48/view-ldap-resource.svg	pass	1659916	858508	801408	0
svgs/oxygen-icons-5.113.0/scalable/actions/small/48x48/view-left-close.svg	pass	45236	5229	40007	0
svgs/oxygen-icons-5.113.0/scalable/actions/small/48x48/view-list-details.svg	pass	79361	7035	72326	0
svgs/oxygen-icons-5.113.0/scalable/actions/small/48x48/view-list-text.svg	pass	79266	7159	72107	0
svgs/oxygen-icons-5.113.0/scalable/actions/small/48x48/view-list-tree.svg	pass	79017	6749	72268	0
svgs/oxygen-icons-5.113.0/scalable/actions/small/48x48/view-loan-asset.svg	pass	549832	122148	427684	0
svgs/oxygen-icons-5.113.0/scalable/actions/small/48x48/view-loan.svg	pass	547292	121268	426024	0
svgs/oxygen-icons-5.113.0/scalable/actions/small/48x48/view-media-equalizer.svg	pass	72708	6924	65784	0
svgs/oxygen-icons-5.113.0/scalable/actions/small/48x48/view-media-lyrics.svg	pass	269874	86338	183536	0
svgs/oxygen-icons-5.113.0/scalable/actions/small/48x48/view-media-playlist.svg	pass	311055	73002	238053	0
svgs/oxygen-icons-5.113.0/scalable/actions/small/48x48/view-multiple-objects.svg	pass	31283	6287	24996	0
svgs/oxygen-icons-5.113.0/scalable/actions/small/48x48/view-pim-contacts.svg	pass	271512	110343	161169	0
svgs/oxygen-icons-5.113.0/scalable/actions/small/48x48/view-pim-journal.svg	pass	153969	16467	137502	0
svgs/oxygen-icons-5.113.0/scalable/actions/small/48x48/view-pim-news.svg	pass	407441	7566	399875	0
svgs/oxygen-icons-5.113.0/scalable/actions/small/48x48/view-pim-tasks-pending.svg	pass	170248	26721	143527	0
svgs/oxygen-icons-5.113.0/scalable/actions/small/48x48/view-pim-tasks.svg	pass	160274	16450	143824	0
svgs/oxygen-icons-5.113.0/scalable/actions/small/48x48/view-preview.svg	pass	114212	38731	75481	0
svgs/oxygen-icons-5.113.0/scalable/actions/small/48x48/view-resource-calendar.svg	pass	210124	40688	169436	0
svgs/oxygen-icons-5.113.0/scalable/actions/small/48x48/view-restore.svg	pass	264196	4302	259894	0
svgs/oxygen-icons-5.113.0/scalable/actions/small/48x48/view-right-close.svg	pass	46612	5070	41542	0
svgs/oxygen-icons-5.113.0/scalable/actions/small/48x48/view-right-new.svg	pass	41883	5111	36772	0
svgs/oxygen-icons-5.113.0/scalable/actions/small/48x48/view-sidetree.svg	pass	81557	8254	73303	0
svgs/oxygen-icons-5.113.0/scalable/actions/small/48x48/view-split-left-right.svg	pass	43407	3977	39430	0
svgs/oxygen-icons-5.113.0/scalable/actions/small/48x48/view-split-top-bottom.svg	pass	43409	3983	39426	0
svgs/oxygen-icons-5.113.0/scalable/actions/small/48x48/view-stock-account.svg	pass	951554	374951	576603	0
svgs/oxygen-icons-5.113.0/scalable/actions/small/48x48/view-table-of-contents-ltr.svg	mismatch	23273	14604	8669	13
svgs/oxygen-icons-5.113.0/scalable/actions/small/48x48/view-table-of-contents-rtl.svg	pass	25474	14951	10523	2
svgs/oxygen-icons-5.113.0/scalable/actions/small/48x48/view-task-add.svg	pass	213444	24057	189387	0
svgs/oxygen-icons-5.113.0/scalable/actions/small/48x48/view-task-child-add.svg	pass	94518	16445	78073	0
svgs/oxygen-icons-5.113.0/scalable/actions/small/48x48/view-task-child.svg	pass	85126	12331	72795	0
svgs/oxygen-icons-5.113.0/scalable/actions/small/48x48/view-time-schedule-baselined-add.svg	pass	430214	150403	279811	0
svgs/oxygen-icons-5.113.0/scalable/actions/small/48x48/view-time-schedule-baselined-remove.svg	pass	432455	154545	277910	0
svgs/oxygen-icons-5.113.0/scalable/actions/small/48x48/view-time-schedule-baselined.svg	pass	266452	144702	121750	0
svgs/oxygen-icons-5.113.0/scalable/actions/small/48x48/view-time-schedule-calculus.svg	mismatch	115007	45051	69956	18
svgs/oxygen-icons-5.113.0/scalable/actions/small/48x48/view-time-schedule-child-insert.svg	pass	140240	15297	124943	0
svgs/oxygen-icons-5.113.0/scalable/actions/small/48x48/view-time-schedule-edit.svg	pass	92174	21323	70851	0
svgs/oxygen-icons-5.113.0/scalable/actions/small/48x48/view-time-schedule-insert.svg	pass	78980	12182	66798	0
svgs/oxygen-icons-5.113.0/scalable/actions/small/48x48/view-time-schedule.svg	pass	71249	8069	63180	0
svgs/oxygen-icons-5.113.0/scalable/actions/small/48x48/window-duplicate.svg	pass	48016	5966	42050	0
svgs/oxygen-icons-5.113.0/scalable/actions/small/48x48/window-new.svg	pass	89650	7216	82434	0
svgs/oxygen-icons-5.113.0/scalable/actions/small/48x48/zoom-1-to-2.svg	pass	31716	12660	19056	0
svgs/oxygen-icons-5.113.0/scalable/actions/small/48x48/zoom-2-to-1.svg	pass	31708	12690	19018	0
svgs/oxygen-icons-5.113.0/scalable/actions/small/48x48/zoom-draw.svg	pass	41412	12342	29070	0
svgs/oxygen-icons-5.113.0/scalable/actions/small/48x48/zoom-fit-best.svg	pass	35958	6417	29541	0
svgs/oxygen-icons-5.113.0/scalable/actions/small/48x48/zoom-fit-height.svg	pass	36482	6424	30058	0
svgs/oxygen-icons-5.113.0/scalable/actions/small/48x48/zoom-fit-width.svg	pass	35741	6414	29327	0
svgs/oxygen-icons-5.113.0/scalable/actions/small/48x48/zoom-in.svg	pass	39833	14695	25138	0
svgs/oxygen-icons-5.113.0/scalable/actions/small/48x48/zoom-next.svg	pass	33493	11013	22480	0
svgs/oxygen-icons-5.113.0/scalable/actions/small/48x48/zoom-original.svg	pass	28646	11609	17037	0
svgs/oxygen-icons-5.113.0/scalable/actions/small/48x48/zoom-out.svg	pass	28573	11773	16800	0
svgs/oxygen-icons-5.113.0/scalable/actions/small/48x48/zoom-previous.svg	pass	31160	11038	20122	0
svgs/oxygen-icons-5.113.0/scalable/actions/small/48x48/zoom-select.svg	pass	209632	19176	190456	0
svgs/oxygen-icons-5.113.0/scalable/actions/speaker.svg	pass	45532	9674	35858	0
svgs/oxygen-icons-5.113.0/scalable/actions/svn-commit.svg	pass	283877	28768	255109	0
svgs/oxygen-icons-5.113.0/scalable/actions/svn-update.svg	pass	151186	28728	122458	0
svgs/oxygen-icons-5.113.0/scalable/actions/system-lock-screen.svg	pass	25449	13600	11849	0
svgs/oxygen-icons-5.113.0/scalable/actions/system-log-out.svg	pass	39109	15436	23673	0
svgs/oxygen-icons-5.113.0/scalable/actions/system-reboot.svg	pass	34928	12764	22164	0
svgs/oxygen-icons-5.113.0/scalable/actions/system-run.svg	pass	85114	47123	37991	2
svgs/oxygen-icons-5.113.0/scalable/actions/system-search.svg	pass	228793	105847	122946	0
svgs/oxygen-icons-5.113.0/scalable/actions/system-shutdown.svg	pass	30109	14964	15145	2
svgs/oxygen-icons-5.113.0/scalable/actions/system-suspend-hibernate.svg	pass	40128	17014	23114	0
svgs/oxygen-icons-5.113.0/scalable/actions/system-suspend.svg	pass	39678	13001	26677	0
svgs/oxygen-icons-5.113.0/scalable/actions/system-switch-user.svg	pass	77244	18702	58542	0
svgs/oxygen-icons-5.113.0/scalable/actions/tab-close-other.svg	pass	198175	15942	182233	0
svgs/oxygen-icons-5.113.0/scalable/actions/tab-close.svg	pass	206097	15720	190377	0
svgs/oxygen-icons-5.113.0/scalable/actions/tab-detach.svg	pass	42942	7347	35595	0
svgs/oxygen-icons-5.113.0/scalable/actions/tab-duplicate.svg	pass	45282	7337	37945	0
svgs/oxygen-icons-5.113.0/scalable/actions/tab-new-background.svg	pass	47161	6136	41025	0
svgs/oxygen-icons-5.113.0/scalable/actions/tab-new.svg	pass	49154	8351	40803	0
svgs/oxygen-icons-5.113.0/scalable/actions/text-speak.svg	pass	12371	6401	5970	0
svgs/oxygen-icons-5.113.0/scalable/actions/tool-animator.svg	pass	46860	16032	30828	0
svgs/oxygen-icons-5.113.0/scalable/actions/tools-media-optical-burn-image.svg	pass	78037	42033	36004	0
svgs/oxygen-icons-5.113.0/scalable/actions/tools-media-optical-burn.svg	pass	75170	43605	31565	0
svgs/oxygen-icons-5.113.0/scalable/actions/tools-media-optical-copy.svg	pass	54928	29221	25707	0
svgs/oxygen-icons-5.113.0/scalable/actions/tools-media-optical-erase.svg	pass	126980	25117	101863	0
svgs/oxygen-icons-5.113.0/scalable/actions/tools-media-optical-format.svg	pass	60877	32875	28002	0
svgs/oxygen-icons-5.113.0/scalable/actions/tools-report-bug.svg	pass	127095	58441	68654	0
svgs/oxygen-icons-5.113.0/scalable/actions/tools-rip-audio-cd.svg	pass	168207	50486	117721	0
svgs/oxygen-icons-5.113.0/scalable/actions/tools-rip-video-cd.svg	pass	196788	38776	158012	0
svgs/oxygen-icons-5.113.0/scalable/actions/tools-rip-video-dvd.svg	pass	213001	42637	170364	0
svgs/oxygen-icons-5.113.0/scalable/actions/tools-wizard.svg	pass	99990	53176	46814	0
svgs/oxygen-icons-5.113.0/scalable/actions/transform-crop-and-resize.svg	pass	166111	11448	154663	0
svgs/oxygen-icons-5.113.0/scalable/actions/transform-crop.svg	pass	21822	9908	11914	0
svgs/oxygen-icons-5.113.0/scalable/actions/transform-move.svg	pass	132098	11060	121038	0
svgs/oxygen-icons-5.113.0/scalable/actions/transform-rotate.svg	pass	12352	4709	7643	0
svgs/oxygen-icons-5.113.0/scalable/actions/transform-scale.svg	pass	19368	6147	13221	0
svgs/oxygen-icons-5.113.0/scalable/actions/trash-empty.svg	pass	250909	9273	241636	0
svgs/oxygen-icons-5.113.0/scalable/actions/user-group-delete.svg	pass	164501	90478	74023	0
svgs/oxygen-icons-5.113.0/scalable/actions/user-group-new.svg	pass	545586	84970	460616	0
svgs/oxygen-icons-5.113.0/scalable/actions/user-group-properties.svg	pass	760054	114356	645698	0
svgs/oxygen-icons-5.113.0/scalable/actions/user-properties.svg	pass	96973	53989	42984	4
svgs/oxygen-icons-5.113.0/scalable/actions/view-calendar-day.svg	pass	72806	34554	38252	0
svgs/oxygen-icons-5.113.0/scalable/actions/view-calendar-list.svg	pass	80422	34654	45768	0
svgs/oxygen-icons-5.113.0/scalable/actions/view-calendar-month.svg	pass	104092	51529	52563	0
svgs/oxygen-icons-5.113.0/scalable/actions/view-calendar-tasks.svg	pass	78834	33789	45045	0
svgs/oxygen-icons-5.113.0/scalable/actions/view-calendar-timeline.svg	pass	79742	38494	41248	0
svgs/oxygen-icons-5.113.0/scalable/actions/view-calendar-upcoming-days.svg	pass	75626	35638	39988	0
svgs/oxygen-icons-5.113.0/scalable/actions/view-calendar-upcoming-events.svg	pass	78380	34066	44314	0
svgs/oxygen-icons-5.113.0/scalable/actions/view-calendar-week.svg	pass	78530	37806	40724	0
svgs/oxygen-icons-5.113.0/scalable/actions/view-calendar-workweek.svg	pass	77477	36724	40753	0
svgs/oxygen-icons-5.113.0/scalable/actions/view-calendar.svg	pass	85429	33909	51520	0
svgs/oxygen-icons-5.113.0/scalable/actions/view-choose.svg	pass	75076	7223	67853	0
svgs/oxygen-icons-5.113.0/scalable/actions/view-close.svg	pass	80103	7226	72877	0
svgs/oxygen-icons-5.113.0/scalable/actions/view-conversation-balloon.svg	pass	28318	14741	13577	0
svgs/oxygen-icons-5.113.0/scalable/actions/view-file-columns.svg	pass	80802	8214	72588	0
svgs/oxygen-icons-5.113.0/scalable/actions/view-filter.svg	pass	29560	12119	17441	0
svgs/oxygen-icons-5.113.0/scalable/actions/view-fullscreen.svg	pass	323718	5171	318547	0
svgs/oxygen-icons-5.113.0/scalable/actions/view-history.svg	pass	39464	19231	20233	0
svgs/oxygen-icons-5.113.0/scalable/actions/view-left-close.svg	pass	83143	9107	74036	0
svgs/oxygen-icons-5.113.0/scalable/actions/view-list-details.svg	pass	84823	11140	73683	0
svgs/oxygen-icons-5.113.0/scalable/actions/view-list-icons.svg	pass	83279	10099	73180	0
svgs/oxygen-icons-5.113.0/scalable/actions/view-list-text.svg	pass	82621	8904	73717	0
svgs/oxygen-icons-5.113.0/scalable/actions/view-list-tree.svg	pass	74903	6642	68261	0
svgs/oxygen-icons-5.113.0/scalable/actions/view-media-artist.svg	pass	21163	8834	12329	0
svgs/oxygen-icons-5.113.0/scalable/actions/view-media-equalizer.svg	pass	38266	19887	18379	0
svgs/oxygen-icons-5.113.0/scalable/actions/view-media-lyrics.svg	pass	262605	74219	188386	0
svgs/oxygen-icons-5.113.0/scalable/actions/view-media-playlist.svg	pass	211021	66463	144558	0
svgs/oxygen-icons-5.113.0/scalable/actions/view-media-visualization.svg	pass	54175	23561	30614	0
svgs/oxygen-icons-5.113.0/scalable/actions/view-object-histogram-linear.svg	pass	22331	10430	11901	0
svgs/oxygen-icons-5.113.0/scalable/actions/view-object-histogram-logarithmic.svg	pass	18380	7896	10484	0
svgs/oxygen-icons-5.113.0/scalable/actions/view-pim-calendar.svg	pass	218256	11070	207186	0
svgs/oxygen-icons-5.113.0/scalable/actions/view-pim-contacts.svg	pass	244012	112756	131256	0
svgs/oxygen-icons-5.113.0/scalable/actions/view-pim-journal.svg	pass	147028	62680	84348	0
svgs/oxygen-icons-5.113.0/scalable/actions/view-pim-mail.svg	pass	215980	58542	157438	0
svgs/oxygen-icons-5.113.0/scalable/actions/view-pim-notes.svg	pass	45512	7772	37740	0
svgs/oxygen-icons-5.113.0/scalable/actions/view-pim-summary.svg	pass	281956	79795	202161	0
svgs/oxygen-icons-5.113.0/scalable/actions/view-presentation.svg	pass	90856	9826	81030	0
svgs/oxygen-icons-5.113.0/scalable/actions/view-preview.svg	pass	114158	38709	75449	0
svgs/oxygen-icons-5.113.0/scalable/actions/view-process-all-tree.svg	pass	20197	4027	16170	0
svgs/oxygen-icons-5.113.0/scalable/actions/view-process-all.svg	pass	20352	3877	16475	0
svgs/oxygen-icons-5.113.0/scalable/actions/view-process-own.svg	pass	17701	7165	10536	0
svgs/oxygen-icons-5.113.0/scalable/actions/view-process-system.svg	pass	19757	8494	11263	0
svgs/oxygen-icons-5.113.0/scalable/actions/view-process-users.svg	pass	31893	10687	21206	0
svgs/oxygen-icons-5.113.0/scalable/actions/view-refresh.svg	pass	58545	16367	42178	0
svgs/oxygen-icons-5.113.0/scalable/actions/view-restore.svg	pass	323002	5376	317626	0
svgs/oxygen-icons-5.113.0/scalable/actions/view-right-close.svg	pass	82960	8958	74002	0
svgs/oxygen-icons-5.113.0/scalable/actions/view-right-new.svg	pass	83139	8985	74154	0
svgs/oxygen-icons-5.113.0/scalable/actions/view-sidetree.svg	pass	76851	7924	68927	0
svgs/oxygen-icons-5.113.0/scalable/actions/view-sort-ascending.svg	pass	17679	7139	10540	0
svgs/oxygen-icons-5.113.0/scalable/actions/view-sort-descending.svg	pass	18405	7205	11200	0
svgs/oxygen-icons-5.113.0/scalable/actions/view-split-left-right.svg	pass	80134	7800	72334	0
svgs/oxygen-icons-5.113.0/scalable/actions/view-split-top-bottom.svg	pass	80130	7809	72321	0
svgs/oxygen-icons-5.113.0/scalable/actions/view-statistics.svg	pass	47293	15941	31352	0
svgs/oxygen-icons-5.113.0/scalable/actions/view-web-browser-dom-tree.svg	pass	107108	51696	55412	0
svgs/oxygen-icons-5.113.0/scalable/actions/window-close.svg	pass	12793	4372	8421	0
svgs/oxygen-icons-5.113.0/scalable/actions/window-duplicate.svg	pass	97989	11823	86166	0
svgs/oxygen-icons-5.113.0/scalable/actions/window-new.svg	pass	91345	11555	79790	0
svgs/oxygen-icons-5.113.0/scalable/actions/zoom-fit-best.svg	pass	34937	5961	28976	0
svgs/oxygen-icons-5.113.0/scalable/actions/zoom-fit-height.svg	pass	35172	5969	29203	0
svgs/oxygen-icons-5.113.0/scalable/actions/zoom-fit-width.svg	pass	34672	5966	28706	0
svgs/oxygen-icons-5.113.0/scalable/applets/applets-template.svg	pass	80396	35305	45091	0
svgs/oxygen-icons-5.113.0/scalable/applets/org.kde.ktpcontactlist.svg	pass	204341	90122	114219	0
svgs/oxygen-icons-5.113.0/scalable/applets/org.kde.muonnotifier.svg	mismatch	1059605	409450	650155	84
svgs/oxygen-icons-5.113.0/scalable/applets/org.kde.plasma.activitybar.svg	pass	133068	56549	76519	0
svgs/oxygen-icons-5.113.0/scalable/applets/org.kde.plasma.analogclock.svg	pass	227390	158150	69240	0
svgs/oxygen-icons-5.113.0/scalable/applets/org.kde.plasma.battery.svg	pass	160599	87020	73579	0
svgs/oxygen-icons-5.113.0/scalable/applets/org.kde.plasma.binaryclock.svg	pass	127028	42447	84581	0
svgs/oxygen-icons-5.113.0/scalable/applets/org.kde.plasma.calculator.svg	pass	158494	58734	99760	0
svgs/oxygen-icons-5.113.0/scalable/applets/org.kde.plasma.calendar.svg	pass	172154	103365	68789	1
svgs/oxygen-icons-5.113.0/scalable/applets/org.kde.plasma.clipboard.svg	mismatch	1790370	1040476	749894	20
svgs/oxygen-icons-5.113.0/scalable/applets/org.kde.plasma.colorpicker.svg	pass	165297	55817	109480	0
svgs/oxygen-icons-5.113.0/scalable/applets/org.kde.plasma.comic.svg	pass	237529	107011	130518	0
svgs/oxygen-icons-5.113.0/scalable/applets/org.kde.plasma.devicenotifier.svg	mismatch	722413	339069	383344	21
svgs/oxygen-icons-5.113.0/scalable/applets/org.kde.plasma.digitalclock.svg	pass	116141	45910	70231	0
svgs/oxygen-icons-5.113.0/scalable/applets/org.kde.plasma.fifteenpuzzle.svg	pass	153041	66286	86755	0
svgs/oxygen-icons-5.113.0/scalable/applets/org.kde.plasma.folder.svg	pass	1735976	1342834	393142	0
svgs/oxygen-icons-5.113.0/scalable/applets/org.kde.plasma.frame.svg	pass	112280	48891	63389	0
svgs/oxygen-icons-5.113.0/scalable/applets/org.kde.plasma.fuzzyclock.svg	pass	113678	43678	70000	0
svgs/oxygen-icons-5.113.0/scalable/applets/org.kde.plasma.icontasks.svg	mismatch	2246526	1151113	1095413	144
svgs/oxygen-icons-5.113.0/scalable/applets/org.kde.plasma.kicker.svg	mismatch	1016329	439541	576788	77
svgs/oxygen-icons-5.113.0/scalable/applets/org.kde.plasma.kickerdash.svg	mismatch	1942311	927502	1014809	351
svgs/oxygen-icons-5.113.0/scalable/applets/org.kde.plasma.kickoff.svg	pass	1109725	457219	652506	1
svgs/oxygen-icons-5.113.0/scalable/applets/org.kde.plasma.mediacontroller.svg	pass	462037	110407	351630	0
svgs/oxygen-icons-5.113.0/scalable/applets/org.kde.plasma.networkmanagement.svg	pass	407625	193294	214331	0
svgs/oxygen-icons-5.113.0/scalable/applets/org.kde.plasma.notes.svg	pass	159739	74921	84818	0
svgs/oxygen-icons-5.113.0/scalable/applets/org.kde.plasma.pager.svg	pass	225748	118316	107432	0
svgs/oxygen-icons-5.113.0/scalable/applets/org.kde.plasma.quicklaunch.svg	mismatch	1432502	680192	752310	63
svgs/oxygen-icons-5.113.0/scalable/applets/org.kde.plasma.showActivityManager.svg	pass	1683782	755276	928506	0
svgs/oxygen-icons-5.113.0/scalable/applets/org.kde.plasma.systemloadviewer.svg	pass	168621	56672	111949	0
svgs/oxygen-icons-5.113.0/scalable/applets/org.kde.plasma.systemmonitor.cpu.svg	pass	602370	260994	341376	0
svgs/oxygen-icons-5.113.0/scalable/applets/org.kde.plasma.systemmonitor.diskactivity.svg	pass	640174	296462	343712	0
svgs/oxygen-icons-5.113.0/scalable/applets/org.kde.plasma.systemmonitor.diskusage.svg	pass	428373	102474	325899	0
svgs/oxygen-icons-5.113.0/scalable/applets/org.kde.plasma.systemmonitor.memory.svg	pass	633804	295098	338706	0
svgs/oxygen-icons-5.113.0/scalable/applets/org.kde.plasma.systemmonitor.net.svg	pass	401451	94398	307053	0
svgs/oxygen-icons-5.113.0/scalable/applets/org.kde.plasma.systemtray.svg	pass	1469879	762664	707215	1
svgs/oxygen-icons-5.113.0/scalable/applets/org.kde.plasma.taskmanager.svg	pass	734583	313664	420919	0
svgs/oxygen-icons-5.113.0/scalable/applets/org.kde.plasma.timer.svg	pass	107550	44321	63229	0
svgs/oxygen-icons-5.113.0/scalable/applets/org.kde.plasma.userswitcher.svg	pass	286654	127004	159650	0
svgs/oxygen-icons-5.113.0/scalable/applets/org.kde.plasma.volume.svg	pass	464827	111614	353213	0
svgs/oxygen-icons-5.113.0/scalable/applets/org.kde.plasma.windowlist.svg	pass	756492	315060	441432	0
svgs/oxygen-icons-5.113.0/scalable/apps/Charm.svg	pass	253293	149087	104206	0
svgs/oxygen-icons-5.113.0/scalable/apps/accessories-calculator.svg	pass	78354	36623	41731	0
svgs/oxygen-icons-5.113.0/scalable/apps/accessories-character-map.svg	pass	20264	8874	11390	0
svgs/oxygen-icons-5.113.0/scalable/apps/accessories-dictionary.svg	pass	51701	31124	20577	0
svgs/oxygen-icons-5.113.0/scalable/apps/accessories-text-editor.svg	pass	548091	194003	354088	3
svgs/oxygen-icons-5.113.0/scalable/apps/acroread.svg	pass	62588	35148	27440	0
svgs/oxygen-icons-5.113.0/scalable/apps/akonadi.svg	pass	74767	38532	36235	0
svgs/oxygen-icons-5.113.0/scalable/apps/akregator.svg	pass	79369	45812	33557	0
svgs/oxygen-icons-5.113.0/scalable/apps/ark.svg	pass	274746	124343	150403	0
svgs/oxygen-icons-5.113.0/scalable/apps/artikulate.svg	pass	39788	22639	17149	0
svgs/oxygen-icons-5.113.0/scalable/apps/basket.svg	mismatch	41012	22398	18614	11
svgs/oxygen-icons-5.113.0/scalable/apps/braindump.svg	pass	52570	7159	45411	0
svgs/oxygen-icons-5.113.0/scalable/apps/calligraauthor.svg	mismatch	95946	14150	81796	5
svgs/oxygen-icons-5.113.0/scalable/apps/calligraflow.svg	pass	73998	5440	68558	0
svgs/oxygen-icons-5.113.0/scalable/apps/calligrakexi.svg	pass	56769	4970	51799	0
svgs/oxygen-icons-5.113.0/scalable/apps/calligrasheets.svg	pass	58805	7674	51131	0
svgs/oxygen-icons-5.113.0/scalable/apps/calligrastage.svg	pass	74359	9189	65170	0
svgs/oxygen-icons-5.113.0/scalable/apps/calligrawords.svg	pass	81395	15741	65654	0
svgs/oxygen-icons-5.113.0/scalable/apps/clock.svg	pass	32526	11768	20758	0
svgs/oxygen-icons-5.113.0/scalable/apps/device-notifier.svg	pass	145185	104469	40716	0
svgs/oxygen-icons-5.113.0/scalable/apps/digikam.svg	mismatch	30053	16881	13172	59
svgs/oxygen-icons-5.113.0/scalable/apps/dragonplayer.svg	pass	117671	62321	55350	0
svgs/oxygen-icons-5.113.0/scalable/apps/esd.svg	pass	2322919	1270618	1052301	0
svgs/oxygen-icons-5.113.0/scalable/apps/fontforge.svg	pass	53168	27066	26102	0
svgs/oxygen-icons-5.113.0/scalable/apps/graphics-viewer-document.svg	pass	99965	47704	52261	1
svgs/oxygen-icons-5.113.0/scalable/apps/hardware.svg	mismatch	254319	104928	149391	20
svgs/oxygen-icons-5.113.0/scalable/apps/help-browser.svg	pass	444600	93492	351108	0
svgs/oxygen-icons-5.113.0/scalable/apps/hidef/Charm.svg	pass	255218	149578	105640	0
svgs/oxygen-icons-5.113.0/scalable/apps/hidef/accessories-calculator.svg	pass	76652	35436	41216	0
svgs/oxygen-icons-5.113.0/scalable/apps/hidef/accessories-dictionary.svg	pass	100923	70476	30447	0
svgs/oxygen-icons-5.113.0/scalable/apps/hidef/internet-web-browser.svg	pass	628792	340849	287943	0
svgs/oxygen-icons-5.113.0/scalable/apps/hidef/kdevelop.svg	pass	225975	32795	193180	0
svgs/oxygen-icons-5.113.0/scalable/apps/hidef/kmag.svg	pass	678977	66656	612321	0
svgs/oxygen-icons-5.113.0/scalable/apps/hidef/kmail2.svg	pass	167932	85002	82930	0
svgs/oxygen-icons-5.113.0/scalable/apps/hidef/kwalletmanager.svg	pass	167132	136162	30970	0
svgs/oxygen-icons-5.113.0/scalable/apps/hidef/mameexecutor.svg	pass	349016	153262	195754	0
svgs/oxygen-icons-5.113.0/scalable/apps/hidef/multimedia-volume-control.svg	pass	387472	165909	221563	0
svgs/oxygen-icons-5.113.0/scalable/apps/hidef/picmi.svg	pass	58936	35400	23536	0
svgs/oxygen-icons-5.113.0/scalable/apps/hidef/preferences-desktop-display-color.svg	pass	228902	77885	151017	0
svgs/oxygen-icons-5.113.0/scalable/apps/hidef/preferences-desktop-display.svg	pass	1304901	1175781	129120	0
svgs/oxygen-icons-5.113.0/scalable/apps/hidef/preferences-desktop-locale.svg	mismatch	142908	105179	37729	9
svgs/oxygen-icons-5.113.0/scalable/apps/hidef/preferences-desktop-thunderbolt.svg	pass	151997	124100	27897	0
svgs/oxygen-icons-5.113.0/scalable/apps/hidef/preferences-system-bluetooth.svg	pass	20519	7324	13195	0
svgs/oxygen-icons-5.113.0/scalable/apps/hidef/preferences-system-login.svg	pass	1307704	1177556	130148	0
svgs/oxygen-icons-5.113.0/scalable/apps/hidef/preferences-system-network-ethernet.svg	pass	274806	236682	38124	0
svgs/oxygen-icons-5.113.0/scalable/apps/hidef/qelectrotech.svg	pass	158591	129191	29400	0
svgs/oxygen-icons-5.113.0/scalable/apps/hidef/yakuake.svg	pass	176701	10246	166455	0
svgs/oxygen-icons-5.113.0/scalable/apps/hwinfo.svg	mismatch	265753	115034	150719	15
svgs/oxygen-icons-5.113.0/scalable/apps/inkscape.svg	pass	33428	16752	16676	0
svgs/oxygen-icons-5.113.0/scalable/apps/internet-mail.svg	pass	145510	77697	67813	1
svgs/oxygen-icons-5.113.0/scalable/apps/internet-telephony.svg	pass	51252	34762	16490	0
svgs/oxygen-icons-5.113.0/scalable/apps/internet-web-browser.svg	pass	731481	341058	390423	3
svgs/oxygen-icons-5.113.0/scalable/apps/java.svg	pass	32338	16163	16175	0
svgs/oxygen-icons-5.113.0/scalable/apps/k3b.svg	pass	862382	162706	699676	0
svgs/oxygen-icons-5.113.0/scalable/apps/kaffeine.svg	pass	63978	30056	33922	1
svgs/oxygen-icons-5.113.0/scalable/apps/kalarm.svg	pass	21774	16904	4870	0
svgs/oxygen-icons-5.113.0/scalable/apps/kblogger.svg	pass	119393	30385	89008	0
svgs/oxygen-icons-5.113.0/scalable/apps/kbruch.svg	pass	541215	141010	400205	0
svgs/oxygen-icons-5.113.0/scalable/apps/kbugbuster.svg	pass	127095	58441	68654	0
svgs/oxygen-icons-5.113.0/scalable/apps/kchart.svg	pass	190110	32074	158036	1
svgs/oxygen-icons-5.113.0/scalable/apps/kcolorchooser.svg	pass	42920	24117	18803	0
svgs/oxygen-icons-5.113.0/scalable/apps/kde-gtk-config.svg	mismatch	20617	7434	13183	10
svgs/oxygen-icons-5.113.0/scalable/apps/kde-windows.svg	pass	151928	127964	23964	0
svgs/oxygen-icons-5.113.0/scalable/apps/kde.svg	pass	20765	8245	12520	0
svgs/oxygen-icons-5.113.0/scalable/apps/kdevelop.svg	pass	227969	32808	195161	0
svgs/oxygen-icons-5.113.0/scalable/apps/kdf.svg	pass	54488	10485	44003	0
svgs/oxygen-icons-5.113.0/scalable/apps/kformula.svg	pass	578059	191709	386350	1
svgs/oxygen-icons-5.113.0/scalable/apps/kig.svg	pass	180534	130571	49963	0
svgs/oxygen-icons-5.113.0/scalable/apps/kivio.svg	pass	185364	45626	139738	1
svgs/oxygen-icons-5.113.0/scalable/apps/kjournal.svg	mismatch	147084	62495	84589	15
svgs/oxygen-icons-5.113.0/scalable/apps/klipper.svg	mismatch	93843	16677	77166	27
svgs/oxygen-icons-5.113.0/scalable/apps/kmag.svg	pass	150810	65510	85300	0
svgs/oxygen-icons-5.113.0/scalable/apps/kmail2.svg	pass	155018	80286	74732	0
svgs/oxygen-icons-5.113.0/scalable/apps/kmplayer.svg	mismatch	115630	54208	61422	44
svgs/oxygen-icons-5.113.0/scalable/apps/kmymoney.svg	mismatch	338454	197723	140731	7
svgs/oxygen-icons-5.113.0/scalable/apps/knewsticker.svg	pass	506437	241835	264602	1
svgs/oxygen-icons-5.113.0/scalable/apps/knotes.svg	pass	47340	17455	29885	1
svgs/oxygen-icons-5.113.0/scalable/apps/kolf.svg	pass	157367	87326	70041	0
svgs/oxygen-icons-5.113.0/scalable/apps/konqueror.svg	pass	220310	68532	151778	0
svgs/oxygen-icons-5.113.0/scalable/apps/kontact-import-wizard.svg	pass	45275	20115	25160	0
svgs/oxygen-icons-5.113.0/scalable/apps/kontact.svg	pass	269138	101489	167649	0
svgs/oxygen-icons-5.113.0/scalable/apps/konversation.svg	pass	42468	19893	22575	0
svgs/oxygen-icons-5.113.0/scalable/apps/kopete-offline.svg	pass	16580	8171	8409	0
svgs/oxygen-icons-5.113.0/scalable/apps/kopete.svg	pass	14606	8140	6466	0
svgs/oxygen-icons-5.113.0/scalable/apps/korgac.svg	pass	121189	60070	61119	0
svgs/oxygen-icons-5.113.0/scalable/apps/kplato.svg	mismatch	72676	38198	34478	29
svgs/oxygen-icons-5.113.0/scalable/apps/kpresenter.svg	pass	69116	36957	32159	0
svgs/oxygen-icons-5.113.0/scalable/apps/krdc.svg	pass	1631340	811954	819386	0
svgs/oxygen-icons-5.113.0/scalable/apps/krfb.svg	mismatch	1552686	762231	790455	9
svgs/oxygen-icons-5.113.0/scalable/apps/ksnapshot.svg	pass	294087	39064	255023	0
svgs/oxygen-icons-5.113.0/scalable/apps/ksniffer.svg	pass	157086	92299	64787	0
svgs/oxygen-icons-5.113.0/scalable/apps/kspread.svg	pass	116494	57648	58846	0
svgs/oxygen-icons-5.113.0/scalable/apps/ksudoku.svg	mismatch	86569	10254	76315	10
svgs/oxygen-icons-5.113.0/scalable/apps/kthesaurus.svg	pass	47781	22689	25092	0
svgs/oxygen-icons-5.113.0/scalable/apps/ktip.svg	pass	69136	28786	40350	0
svgs/oxygen-icons-5.113.0/scalable/apps/ktorrent.svg	pass	314734	151113	163621	0
svgs/oxygen-icons-5.113.0/scalable/apps/kuickshow.svg	pass	151269	71352	79917	0
svgs/oxygen-icons-5.113.0/scalable/apps/kverbos.svg	pass	190770	111159	79611	0
svgs/oxygen-icons-5.113.0/scalable/apps/kwalletmanager.svg	pass	462033	119349	342684	0
svgs/oxygen-icons-5.113.0/scalable/apps/kword.svg	pass	999875	392579	607296	0
svgs/oxygen-icons-5.113.0/scalable/apps/lokalize.svg	pass	160874	74158	86716	1
svgs/oxygen-icons-5.113.0/scalable/apps/mameexecutor.svg	pass	348156	152680	195476	0
svgs/oxygen-icons-5.113.0/scalable/apps/multimedia-volume-control.svg	pass	414114	77212	336902	0
svgs/oxygen-icons-5.113.0/scalable/apps/muondiscover.svg	pass	562459	417907	144552	0
svgs/oxygen-icons-5.113.0/scalable/apps/nepomuk.svg	pass	163967	55595	108372	0
svgs/oxygen-icons-5.113.0/scalable/apps/office-address-book.svg	pass	100064	34981	65083	0
svgs/oxygen-icons-5.113.0/scalable/apps/office-calendar.svg	pass	97737	48504	49233	0
svgs/oxygen-icons-5.113.0/scalable/apps/okteta.svg	mismatch	351751	75273	276478	6
svgs/oxygen-icons-5.113.0/scalable/apps/okular.svg	pass	99965	47704	52261	1
svgs/oxygen-icons-5.113.0/scalable/apps/oxygen.svg	pass	20662	9724	10938	3
svgs/oxygen-icons-5.113.0/scalable/apps/partitionmanager.svg	pass	75907	44342	31565	0
svgs/oxygen-icons-5.113.0/scalable/apps/picmi.svg	mismatch	60607	37708	22899	22
svgs/oxygen-icons-5.113.0/scalable/apps/planner.svg	pass	204796	143605	61191	0
svgs/oxygen-icons-5.113.0/scalable/apps/plasma.svg	pass	53335	19251	34084	0
svgs/oxygen-icons-5.113.0/scalable/apps/plasmagik.svg	pass	99990	53176	46814	0
svgs/oxygen-icons-5.113.0/scalable/apps/preferences-contact-list.svg	pass	283374	64439	218935	0
svgs/oxygen-icons-5.113.0/scalable/apps/preferences-desktop-accessibility.svg	pass	57680	11926	45754	0
svgs/oxygen-icons-5.113.0/scalable/apps/preferences-desktop-color.svg	pass	54175	23561	30614	0
svgs/oxygen-icons-5.113.0/scalable/apps/preferences-desktop-cryptography.svg	pass	314235	204687	109548	0
svgs/oxygen-icons-5.113.0/scalable/apps/preferences-desktop-default-applications.svg	pass	288918	246073	42845	0
svgs/oxygen-icons-5.113.0/scalable/apps/preferences-desktop-display-color.svg	pass	233169	78004	155165	0
svgs/oxygen-icons-5.113.0/scalable/apps/preferences-desktop-display.svg	pass	1304483	1175379	129104	0
svgs/oxygen-icons-5.113.0/scalable/apps/preferences-desktop-filetype-association.svg	pass	1030863	417904	612959	1
svgs/oxygen-icons-5.113.0/scalable/apps/preferences-desktop-font.svg	pass	46157	17746	28411	0
svgs/oxygen-icons-5.113.0/scalable/apps/preferences-desktop-gaming.svg	pass	92026	50129	41897	0
svgs/oxygen-icons-5.113.0/scalable/apps/preferences-desktop-icons.svg	pass	153329	77712	75617	0
svgs/oxygen-icons-5.113.0/scalable/apps/preferences-desktop-keyboard.svg	pass	34600	16482	18118	0
svgs/oxygen-icons-5.113.0/scalable/apps/preferences-desktop-launch-feedback.svg	pass	29518	16621	12897	0
svgs/oxygen-icons-5.113.0/scalable/apps/preferences-desktop-locale.svg	pass	182066	105232	76834	0
svgs/oxygen-icons-5.113.0/scalable/apps/preferences-desktop-mouse.svg	pass	40945	13962	26983	0
svgs/oxygen-icons-5.113.0/scalable/apps/preferences-desktop-notification-bell.svg	pass	29691	14941	14750	0
svgs/oxygen-icons-5.113.0/scalable/apps/preferences-desktop-notification.svg	pass	107020	12196	94824	0
svgs/oxygen-icons-5.113.0/scalable/apps/preferences-desktop-printer.svg	pass	718618	328957	389661	0
svgs/oxygen-icons-5.113.0/scalable/apps/preferences-desktop-screensaver.svg	pass	57808	26848	30960	0
svgs/oxygen-icons-5.113.0/scalable/apps/preferences-desktop-search.svg	pass	158929	65181	93748	0
svgs/oxygen-icons-5.113.0/scalable/apps/preferences-desktop-sound.svg	pass	216285	9612	206673	0
svgs/oxygen-icons-5.113.0/scalable/apps/preferences-desktop-text-to-speech.svg	pass	61257	14734	46523	1
svgs/oxygen-icons-5.113.0/scalable/apps/preferences-desktop-theme.svg	pass	158230	76592	81638	1
svgs/oxygen-icons-5.113.0/scalable/apps/preferences-desktop-thunderbolt.svg	pass	150247	123387	26860	0
svgs/oxygen-icons-5.113.0/scalable/apps/preferences-desktop-user-password.svg	mismatch	465283	229453	235830	8
svgs/oxygen-icons-5.113.0/scalable/apps/preferences-desktop-user.svg	pass	272779	52744	220035	1
svgs/oxygen-icons-5.113.0/scalable/apps/preferences-desktop-wallpaper.svg	pass	910453	557649	352804	0
svgs/oxygen-icons-5.113.0/scalable/apps/preferences-kcalc-constants.svg	pass	23753	11707	12046	0
svgs/oxygen-icons-5.113.0/scalable/apps/preferences-plugin-script.svg	pass	26915	15042	11873	0
svgs/oxygen-icons-5.113.0/scalable/apps/preferences-plugin.svg	pass	25971	10397	15574	0
svgs/oxygen-icons-5.113.0/scalable/apps/preferences-system-bluetooth-inactive.svg	pass	19631	6942	12689	0
svgs/oxygen-icons-5.113.0/scalable/apps/preferences-system-bluetooth.svg	pass	20519	7324	13195	0
svgs/oxygen-icons-5.113.0/scalable/apps/preferences-system-login.svg	pass	1307478	1176792	130686	0
svgs/oxygen-icons-5.113.0/scalable/apps/preferences-system-network-ethernet.svg	pass	142568	126540	16028	0
svgs/oxygen-icons-5.113.0/scalable/apps/preferences-system-network-sharing.svg	pass	219015	69779	149236	1
svgs/oxygen-icons-5.113.0/scalable/apps/preferences-system-performance.svg	pass	29518	16621	12897	0
svgs/oxygen-icons-5.113.0/scalable/apps/preferences-system-power-management.svg	pass	89730	43411	46319	3
svgs/oxygen-icons-5.113.0/scalable/apps/preferences-system-session-services.svg	pass	32790	16964	15826	0
svgs/oxygen-icons-5.113.0/scalable/apps/preferences-system-time.svg	mismatch	49059	19746	29313	5
svgs/oxygen-icons-5.113.0/scalable/apps/preferences-system-windows-actions.svg	pass	126442	63987	62455	0
svgs/oxygen-icons-5.113.0/scalable/apps/preferences-system-windows-move.svg	pass	342272	34603	307669	0
svgs/oxygen-icons-5.113.0/scalable/apps/preferences-system-windows.svg	pass	242378	43836	198542	0
svgs/oxygen-icons-5.113.0/scalable/apps/preferences-web-browser-adblock.svg	pass	148931	24144	124787	0
svgs/oxygen-icons-5.113.0/scalable/apps/preferences-web-browser-cache.svg	pass	162895	10846	152049	0
svgs/oxygen-icons-5.113.0/scalable/apps/preferences-web-browser-cookies.svg	pass	97964	53918	44046	2
svgs/oxygen-icons-5.113.0/scalable/apps/preferences-web-browser-identification.svg	pass	42424	23201	19223	0
svgs/oxygen-icons-5.113.0/scalable/apps/preferences-web-browser-shortcuts.svg	pass	692615	348893	343722	0
svgs/oxygen-icons-5.113.0/scalable/apps/preferences-web-browser-stylesheets.svg	pass	63684	27801	35883	0
svgs/oxygen-icons-5.113.0/scalable/apps/qelectrotech.svg	pass	427348	132266	295082	0
svgs/oxygen-icons-5.113.0/scalable/apps/quassel.svg	pass	794573	360416	434157	0
svgs/oxygen-icons-5.113.0/scalable/apps/scribus.svg	pass	90906	14641	76265	0
svgs/oxygen-icons-5.113.0/scalable/apps/semn.svg	pass	221694	15183	206511	0
svgs/oxygen-icons-5.113.0/scalable/apps/showfoto.svg	mismatch	29293	16693	12600	58
svgs/oxygen-icons-5.113.0/scalable/apps/skrooge-black.svg	pass	39079	13860	25219	0
svgs/oxygen-icons-5.113.0/scalable/apps/skrooge-initial.svg	pass	30225	12445	17780	0
svgs/oxygen-icons-5.113.0/scalable/apps/skrooge.svg	pass	29411	11641	17770	0
svgs/oxygen-icons-5.113.0/scalable/apps/small/16x16/Charm.svg	pass	202207	121056	81151	0
svgs/oxygen-icons-5.113.0/scalable/apps/small/16x16/accessories-calculator.svg	pass	105797	38874	66923	0
svgs/oxygen-icons-5.113.0/scalable/apps/small/16x16/accessories-character-map.svg	pass	12117	3641	8476	0
svgs/oxygen-icons-5.113.0/scalable/apps/small/16x16/accessories-dictionary.svg	pass	14612	5704	8908	0
svgs/oxygen-icons-5.113.0/scalable/apps/small/16x16/accessories-text-editor.svg	pass	859294	116392	742902	0
svgs/oxygen-icons-5.113.0/scalable/apps/small/16x16/akregator.svg	pass	108907	53276	55631	0
svgs/oxygen-icons-5.113.0/scalable/apps/small/16x16/basket.svg	pass	17271	4715	12556	1
svgs/oxygen-icons-5.113.0/scalable/apps/small/16x16/clock.svg	pass	23380	9144	14236	0
svgs/oxygen-icons-5.113.0/scalable/apps/small/16x16/digikam.svg	mismatch	30053	16881	13172	59
svgs/oxygen-icons-5.113.0/scalable/apps/small/16x16/graphics-viewer-document.svg	pass	25087	4498	20589	0
svgs/oxygen-icons-5.113.0/scalable/apps/small/16x16/internet-mail.svg	pass	96521	20194	76327	0
svgs/oxygen-icons-5.113.0/scalable/apps/small/16x16/java.svg	pass	34184	15507	18677	0
svgs/oxygen-icons-5.113.0/scalable/apps/small/16x16/k3b.svg	pass	862064	162277	699787	1
svgs/oxygen-icons-5.113.0/scalable/apps/small/16x16/kaffeine.svg	pass	62045	30755	31290	1
svgs/oxygen-icons-5.113.0/scalable/apps/small/16x16/kchart.svg	mismatch	184554	24239	160315	5
svgs/oxygen-icons-5.113.0/scalable/apps/small/16x16/kde.svg	pass	24156	10086	14070	0
svgs/oxygen-icons-5.113.0/scalable/apps/small/16x16/kdevelop.svg	pass	230465	32269	198196	0
svgs/oxygen-icons-5.113.0/scalable/apps/small/16x16/kformula.svg	pass	438021	128565	309456	2
svgs/oxygen-icons-5.113.0/scalable/apps/small/16x16/kig.svg	pass	149077	4512	144565	0
svgs/oxygen-icons-5.113.0/scalable/apps/small/16x16/kivio.svg	pass	119720	9113	110607	1
svgs/oxygen-icons-5.113.0/scalable/apps/small/16x16/kmag.svg	pass	678668	60628	618040	0
svgs/oxygen-icons-5.113.0/scalable/apps/small/16x16/knetattach.svg	pass	1195796	126773	1069023	0
svgs/oxygen-icons-5.113.0/scalable/apps/small/16x16/knewsticker.svg	pass	389028	249244	139784	2
svgs/oxygen-icons-5.113.0/scalable/apps/small/16x16/knotes.svg	pass	373672	20210	353462	0
svgs/oxygen-icons-5.113.0/scalable/apps/small/16x16/konqueror.svg	pass	137049	51430	85619	0
svgs/oxygen-icons-5.113.0/scalable/apps/small/16x16/korgac.svg	pass	24005	11062	12943	0
svgs/oxygen-icons-5.113.0/scalable/apps/small/16x16/kplato.svg	pass	54580	22340	32240	0
svgs/oxygen-icons-5.113.0/scalable/apps/small/16x16/kpresenter.svg	pass	65155	31335	33820	0
svgs/oxygen-icons-5.113.0/scalable/apps/small/16x16/ksnapshot.svg	pass	144694	46083	98611	0
svgs/oxygen-icons-5.113.0/scalable/apps/small/16x16/kspread.svg	pass	110863	35853	75010	0
svgs/oxygen-icons-5.113.0/scalable/apps/small/16x16/kword.svg	pass	927110	349602	577508	0
svgs/oxygen-icons-5.113.0/scalable/apps/small/16x16/multimedia-volume-control.svg	pass	41203	19585	21618	0
svgs/oxygen-icons-5.113.0/scalable/apps/small/16x16/office-address-book.svg	pass	66277	34965	31312	0
svgs/oxygen-icons-5.113.0/scalable/apps/small/16x16/office-calendar.svg	pass	28362	6309	22053	0
svgs/oxygen-icons-5.113.0/scalable/apps/small/16x16/picmi.svg	pass	38075	18064	20011	2
svgs/oxygen-icons-5.113.0/scalable/apps/small/16x16/preferences-contact-list.svg	pass	311860	78541	233319	0
svgs/oxygen-icons-5.113.0/scalable/apps/small/16x16/preferences-desktop-accessibility.svg	pass	56315	9200	47115	0
svgs/oxygen-icons-5.113.0/scalable/apps/small/16x16/preferences-desktop-display-color.svg	pass	189985	54028	135957	0
svgs/oxygen-icons-5.113.0/scalable/apps/small/16x16/preferences-desktop-font.svg	pass	42455	4704	37751	0
svgs/oxygen-icons-5.113.0/scalable/apps/small/16x16/preferences-desktop-gaming.svg	pass	69411	30631	38780	0
svgs/oxygen-icons-5.113.0/scalable/apps/small/16x16/preferences-desktop-icons.svg	pass	128643	46760	81883	0
svgs/oxygen-icons-5.113.0/scalable/apps/small/16x16/preferences-desktop-mouse.svg	pass	30329	13339	16990	0
svgs/oxygen-icons-5.113.0/scalable/apps/small/16x16/preferences-desktop-notification-bell.svg	pass	25091	11086	14005	0
svgs/oxygen-icons-5.113.0/scalable/apps/small/16x16/preferences-desktop-printer.svg	pass	823576	329007	494569	0
svgs/oxygen-icons-5.113.0/scalable/apps/small/16x16/preferences-desktop-text-to-speech.svg	pass	58523	10354	48169	0
svgs/oxygen-icons-5.113.0/scalable/apps/small/16x16/preferences-desktop-theme.svg	pass	157641	76319	81322	1
svgs/oxygen-icons-5.113.0/scalable/apps/small/16x16/preferences-desktop-user.svg	pass	289867	55067	234800	0
svgs/oxygen-icons-5.113.0/scalable/apps/small/16x16/preferences-plugin.svg	pass	28002	9272	18730	0
svgs/oxygen-icons-5.113.0/scalable/apps/small/16x16/preferences-system-login.svg	pass	1265542	1153072	112470	4
svgs/oxygen-icons-5.113.0/scalable/apps/small/16x16/preferences-system-windows-actions.svg	pass	288442	59333	229109	0
svgs/oxygen-icons-5.113.0/scalable/apps/small/16x16/preferences-system-windows-move.svg	pass	227591	27644	199947	0
svgs/oxygen-icons-5.113.0/scalable/apps/small/16x16/preferences-system-windows.svg	pass	212042	20710	191332	1
svgs/oxygen-icons-5.113.0/scalable/apps/small/16x16/preferences-web-browser-identification.svg	pass	217286	63760	153526	0
svgs/oxygen-icons-5.113.0/scalable/apps/small/16x16/preferences-web-browser-stylesheets.svg	pass	64978	29140	35838	0
svgs/oxygen-icons-5.113.0/scalable/apps/small/16x16/qelectrotech.svg	pass	414386	114385	300001	0
svgs/oxygen-icons-5.113.0/scalable/apps/small/16x16/scribus.svg	pass	10996	5152	5844	0
svgs/oxygen-icons-5.113.0/scalable/apps/small/16x16/showfoto.svg	mismatch	29293	16693	12600	58
svgs/oxygen-icons-5.113.0/scalable/apps/small/16x16/system-file-manager.svg	mismatch	17638	6041	11597	7
svgs/oxygen-icons-5.113.0/scalable/apps/small/16x16/utilities-file-archiver.svg	pass	7595	3421	4174	0
svgs/oxygen-icons-5.113.0/scalable/apps/small/16x16/utilities-system-monitor.svg	pass	72150	34281	37869	0
svgs/oxygen-icons-5.113.0/scalable/apps/small/16x16/utilities-terminal.svg	pass	124016	29912	94104	0
svgs/oxygen-icons-5.113.0/scalable/apps/small/16x16/yakuake.svg	pass	166709	10056	156653	0
svgs/oxygen-icons-5.113.0/scalable/apps/small/22x22/Charm.svg	pass	214137	129751	84386	2
svgs/oxygen-icons-5.113.0/scalable/apps/small/22x22/accessories-dictionary.svg	pass	42875	17219	25656	0
svgs/oxygen-icons-5.113.0/scalable/apps/small/22x22/basket.svg	mismatch	41612	22766	18846	24
svgs/oxygen-icons-5.113.0/scalable/apps/small/22x22/clock.svg	pass	24813	10563	14250	0
svgs/oxygen-icons-5.113.0/scalable/apps/small/22x22/device-notifier.svg	pass	147727	98226	49501	0
svgs/oxygen-icons-5.113.0/scalable/apps/small/22x22/digikam.svg	mismatch	30053	16881	13172	59
svgs/oxygen-icons-5.113.0/scalable/apps/small/22x22/graphics-viewer-document.svg	pass	114054	5120	108934	0
svgs/oxygen-icons-5.113.0/scalable/apps/small/22x22/inkscape.svg	pass	24685	12364	12321	0
svgs/oxygen-icons-5.113.0/scalable/apps/small/22x22/java.svg	pass	35397	16183	19214	0
svgs/oxygen-icons-5.113.0/scalable/apps/small/22x22/kaffeine.svg	pass	62045	30755	31290	1
svgs/oxygen-icons-5.113.0/scalable/apps/small/22x22/kchart.svg	pass	189487	28864	160623	1
svgs/oxygen-icons-5.113.0/scalable/apps/small/22x22/kde.svg	pass	24756	10044	14712	0
svgs/oxygen-icons-5.113.0/scalable/apps/small/22x22/kdevelop.svg	pass	229650	33566	196084	0
svgs/oxygen-icons-5.113.0/scalable/apps/small/22x22/kdf.svg	pass	53630	9974	43656	0
svgs/oxygen-icons-5.113.0/scalable/apps/small/22x22/kformula.svg	pass	440815	130018	310797	1
svgs/oxygen-icons-5.113.0/scalable/apps/small/22x22/kig.svg	pass	148501	4745	143756	0
svgs/oxygen-icons-5.113.0/scalable/apps/small/22x22/klipper.svg	mismatch	92879	16040	76839	25
svgs/oxygen-icons-5.113.0/scalable/apps/small/22x22/kmag.svg	pass	677866	60633	617233	0
svgs/oxygen-icons-5.113.0/scalable/apps/small/22x22/knetattach.svg	pass	1561633	126423	1435210	0
svgs/oxygen-icons-5.113.0/scalable/apps/small/22x22/korgac.svg	pass	48980	15014	33966	1
svgs/oxygen-icons-5.113.0/scalable/apps/small/22x22/kplato.svg	pass	49568	24417	25151	0
svgs/oxygen-icons-5.113.0/scalable/apps/small/22x22/kpresenter.svg	pass	68627	33788	34839	0
svgs/oxygen-icons-5.113.0/scalable/apps/small/22x22/ksnapshot.svg	pass	109667	34369	75298	0
svgs/oxygen-icons-5.113.0/scalable/apps/small/22x22/kspread.svg	pass	144090	52162	91928	2
svgs/oxygen-icons-5.113.0/scalable/apps/small/22x22/kword.svg	pass	953858	361284	592574	0
svgs/oxygen-icons-5.113.0/scalable/apps/small/22x22/multimedia-volume-control.svg	pass	41392	21354	20038	1
svgs/oxygen-icons-5.113.0/scalable/apps/small/22x22/office-address-book.svg	pass	93017	43914	49103	3
svgs/oxygen-icons-5.113.0/scalable/apps/small/22x22/office-calendar.svg	pass	16051	5690	10361	0
svgs/oxygen-icons-5.113.0/scalable/apps/small/22x22/package-utilities.svg	pass	126127	70458	55669	0
svgs/oxygen-icons-5.113.0/scalable/apps/small/22x22/picmi.svg	pass	39200	18621	20579	2
svgs/oxygen-icons-5.113.0/scalable/apps/small/22x22/preferences-contact-list.svg	pass	318763	82578	236185	0
svgs/oxygen-icons-5.113.0/scalable/apps/small/22x22/preferences-desktop-accessibility.svg	pass	54039	9231	44808	0
svgs/oxygen-icons-5.113.0/scalable/apps/small/22x22/preferences-desktop-display-color.svg	pass	305994	79907	226087	0
svgs/oxygen-icons-5.113.0/scalable/apps/small/22x22/preferences-desktop-font.svg	pass	25688	4367	21321	0
svgs/oxygen-icons-5.113.0/scalable/apps/small/22x22/preferences-desktop-gaming.svg	pass	80227	42389	37838	0
svgs/oxygen-icons-5.113.0/scalable/apps/small/22x22/preferences-desktop-icons.svg	pass	132608	46779	85829	0
svgs/oxygen-icons-5.113.0/scalable/apps/small/22x22/preferences-desktop-mouse.svg	pass	33560	15339	18221	0
svgs/oxygen-icons-5.113.0/scalable/apps/small/22x22/preferences-desktop-notification-bell.svg	pass	29152	14765	14387	0
svgs/oxygen-icons-5.113.0/scalable/apps/small/22x22/preferences-system-windows-move.svg	pass	287974	58978	228996	0
svgs/oxygen-icons-5.113.0/scalable/apps/small/22x22/preferences-system-windows.svg	pass	206214	20714	185500	0
svgs/oxygen-icons-5.113.0/scalable/apps/small/22x22/qelectrotech.svg	pass	413607	113657	299950	0
svgs/oxygen-icons-5.113.0/scalable/apps/small/22x22/scribus.svg	pass	26522	12731	13791	0
svgs/oxygen-icons-5.113.0/scalable/apps/small/22x22/showfoto.svg	mismatch	29293	16693	12600	58
svgs/oxygen-icons-5.113.0/scalable/apps/small/22x22/system-file-manager.svg	pass	18508	6719	11789	1
svgs/oxygen-icons-5.113.0/scalable/apps/small/22x22/utilities-system-monitor.svg	pass	19399	7059	12340	0
svgs/oxygen-icons-5.113.0/scalable/apps/small/22x22/utilities-terminal.svg	pass	124682	28081	96601	0
svgs/oxygen-icons-5.113.0/scalable/apps/small/22x22/yakuake.svg	pass	165851	11309	154542	0
svgs/oxygen-icons-5.113.0/scalable/apps/small/32x32/Charm.svg	pass	219822	133736	86086	2
svgs/oxygen-icons-5.113.0/scalable/apps/small/32x32/clock.svg	pass	30853	10547	20306	0
svgs/oxygen-icons-5.113.0/scalable/apps/small/32x32/device-notifier.svg	pass	147213	100545	46668	0
svgs/oxygen-icons-5.113.0/scalable/apps/small/32x32/digikam.svg	mismatch	30053	16881	13172	59
svgs/oxygen-icons-5.113.0/scalable/apps/small/32x32/k3b.svg	pass	199351	162025	37326	0
svgs/oxygen-icons-5.113.0/scalable/apps/small/32x32/kchart.svg	pass	189068	28753	160315	0
svgs/oxygen-icons-5.113.0/scalable/apps/small/32x32/kdf.svg	pass	53545	9829	43716	0
svgs/oxygen-icons-5.113.0/scalable/apps/small/32x32/kformula.svg	pass	440747	129748	310999	1
svgs/oxygen-icons-5.113.0/scalable/apps/small/32x32/kig.svg	pass	161601	112115	49486	0
svgs/oxygen-icons-5.113.0/scalable/apps/small/32x32/klipper.svg	mismatch	92879	16040	76839	25
svgs/oxygen-icons-5.113.0/scalable/apps/small/32x32/kmag.svg	pass	679880	61451	618429	0
svgs/oxygen-icons-5.113.0/scalable/apps/small/32x32/knetattach.svg	pass	371932	125430	246502	0
svgs/oxygen-icons-5.113.0/scalable/apps/small/32x32/knewsticker.svg	pass	507816	244177	263639	2
svgs/oxygen-icons-5.113.0/scalable/apps/small/32x32/korgac.svg	pass	153553	60012	93541	0
svgs/oxygen-icons-5.113.0/scalable/apps/small/32x32/kplato.svg	pass	58269	30301	27968	0
svgs/oxygen-icons-5.113.0/scalable/apps/small/32x32/kpresenter.svg	pass	72111	37214	34897	0
svgs/oxygen-icons-5.113.0/scalable/apps/small/32x32/kspread.svg	pass	152657	57465	95192	0
svgs/oxygen-icons-5.113.0/scalable/apps/small/32x32/kwalletmanager.svg	pass	233525	113518	120007	0
svgs/oxygen-icons-5.113.0/scalable/apps/small/32x32/kword.svg	pass	988453	385574	602879	0
svgs/oxygen-icons-5.113.0/scalable/apps/small/32x32/picmi.svg	pass	39213	20649	18564	0
svgs/oxygen-icons-5.113.0/scalable/apps/small/32x32/preferences-desktop-display-color.svg	pass	305995	79907	226088	0
svgs/oxygen-icons-5.113.0/scalable/apps/small/32x32/preferences-desktop-display.svg	pass	1305508	1176533	128975	0
svgs/oxygen-icons-5.113.0/scalable/apps/small/32x32/preferences-desktop-font.svg	pass	47208	17953	29255	0
svgs/oxygen-icons-5.113.0/scalable/apps/small/32x32/preferences-desktop-notification-bell.svg	pass	28794	14574	14220	0
svgs/oxygen-icons-5.113.0/scalable/apps/small/32x32/preferences-desktop-screensaver.svg	pass	50149	25864	24285	0
svgs/oxygen-icons-5.113.0/scalable/apps/small/32x32/preferences-desktop-search.svg	pass	106708	65568	41140	1
svgs/oxygen-icons-5.113.0/scalable/apps/small/32x32/preferences-desktop-thunderbolt.svg	pass	150975	123631	27344	0
svgs/oxygen-icons-5.113.0/scalable/apps/small/32x32/preferences-desktop-user.svg	pass	286579	55122	231457	1
svgs/oxygen-icons-5.113.0/scalable/apps/small/32x32/preferences-system-login.svg	pass	1308942	1178335	130607	0
svgs/oxygen-icons-5.113.0/scalable/apps/small/32x32/preferences-system-network-ethernet.svg	pass	154571	125570	29001	0
svgs/oxygen-icons-5.113.0/scalable/apps/small/32x32/preferences-system-windows-actions.svg	pass	408581	64032	344549	0
svgs/oxygen-icons-5.113.0/scalable/apps/small/32x32/preferences-system-windows-move.svg	mismatch	349681	33117	316564	98
svgs/oxygen-icons-5.113.0/scalable/apps/small/32x32/preferences-system-windows.svg	pass	224584	25202	199382	0
svgs/oxygen-icons-5.113.0/scalable/apps/small/32x32/qelectrotech.svg	pass	425268	125666	299602	0
svgs/oxygen-icons-5.113.0/scalable/apps/small/32x32/showfoto.svg	mismatch	29293	16693	12600	58
svgs/oxygen-icons-5.113.0/scalable/apps/small/32x32/system-file-manager.svg	mismatch	20934	8334	12600	14
svgs/oxygen-icons-5.113.0/scalable/apps/small/32x32/yakuake.svg	pass	167222	11062	156160	0
svgs/oxygen-icons-5.113.0/scalable/apps/small/48x48/Charm.svg	pass	229549	137614	91935	0
svgs/oxygen-icons-5.113.0/scalable/apps/small/48x48/digikam.svg	mismatch	30053	16881	13172	59
svgs/oxygen-icons-5.113.0/scalable/apps/small/48x48/kchart.svg	pass	189153	29185	159968	1
svgs/oxygen-icons-5.113.0/scalable/apps/small/48x48/kdevelop.svg	pass	236865	33505	203360	0
svgs/oxygen-icons-5.113.0/scalable/apps/small/48x48/kdf.svg	pass	54522	10581	43941	0
svgs/oxygen-icons-5.113.0/scalable/apps/small/48x48/kformula.svg	pass	528966	168343	360623	1
svgs/oxygen-icons-5.113.0/scalable/apps/small/48x48/kig.svg	mismatch	182010	131867	50143	10
svgs/oxygen-icons-5.113.0/scalable/apps/small/48x48/kivio.svg	pass	141574	18526	123048	1
svgs/oxygen-icons-5.113.0/scalable/apps/small/48x48/kmag.svg	pass	672864	61392	611472	0
svgs/oxygen-icons-5.113.0/scalable/apps/small/48x48/knetattach.svg	pass	197715	125684	72031	0
svgs/oxygen-icons-5.113.0/scalable/apps/small/48x48/knewsticker.svg	pass	514396	249402	264994	0
svgs/oxygen-icons-5.113.0/scalable/apps/small/48x48/kplato.svg	pass	70684	38163	32521	0
svgs/oxygen-icons-5.113.0/scalable/apps/small/48x48/kpresenter.svg	pass	69869	37383	32486	0
svgs/oxygen-icons-5.113.0/scalable/apps/small/48x48/kspread.svg	pass	156085	59005	97080	0
svgs/oxygen-icons-5.113.0/scalable/apps/small/48x48/kwalletmanager.svg	pass	233628	113699	119929	0
svgs/oxygen-icons-5.113.0/scalable/apps/small/48x48/kword.svg	pass	1005398	391770	613628	0
svgs/oxygen-icons-5.113.0/scalable/apps/small/48x48/mameexecutor.svg	pass	334828	140408	194420	0
svgs/oxygen-icons-5.113.0/scalable/apps/small/48x48/picmi.svg	pass	40238	21911	18327	0
svgs/oxygen-icons-5.113.0/scalable/apps/small/48x48/preferences-desktop-display-color.svg	pass	70337	23356	46981	0
svgs/oxygen-icons-5.113.0/scalable/apps/small/48x48/preferences-desktop-font.svg	pass	52637	19609	33028	0
svgs/oxygen-icons-5.113.0/scalable/apps/small/48x48/preferences-desktop-notification-bell.svg	pass	30030	15020	15010	0
svgs/oxygen-icons-5.113.0/scalable/apps/small/48x48/preferences-desktop-screensaver.svg	pass	73938	26123	47815	0
svgs/oxygen-icons-5.113.0/scalable/apps/small/48x48/preferences-system-windows-actions.svg	pass	396396	64005	332391	0
svgs/oxygen-icons-5.113.0/scalable/apps/small/48x48/preferences-system-windows-move.svg	pass	337081	33138	303943	0
svgs/oxygen-icons-5.113.0/scalable/apps/small/48x48/preferences-system-windows.svg	pass	243107	44254	198853	0
svgs/oxygen-icons-5.113.0/scalable/apps/small/48x48/qelectrotech.svg	pass	424873	125600	299273	0
svgs/oxygen-icons-5.113.0/scalable/apps/small/48x48/showfoto.svg	mismatch	29293	16693	12600	58
svgs/oxygen-icons-5.113.0/scalable/apps/small/48x48/yakuake.svg	pass	169465	12767	156698	0
svgs/oxygen-icons-5.113.0/scalable/apps/small/64x64/Charm.svg	pass	251358	148489	102869	0
svgs/oxygen-icons-5.113.0/scalable/apps/small/64x64/kchart.svg	pass	186917	29164	157753	3
svgs/oxygen-icons-5.113.0/scalable/apps/small/64x64/kformula.svg	pass	558225	182100	376125	1
svgs/oxygen-icons-5.113.0/scalable/apps/small/64x64/kivio.svg	pass	154377	29041	125336	1
svgs/oxygen-icons-5.113.0/scalable/apps/small/64x64/kmag.svg	pass	673306	67252	606054	0
svgs/oxygen-icons-5.113.0/scalable/apps/small/64x64/kplato.svg	mismatch	73720	39101	34619	27
svgs/oxygen-icons-5.113.0/scalable/apps/small/64x64/kpresenter.svg	pass	68941	36692	32249	0
svgs/oxygen-icons-5.113.0/scalable/apps/small/64x64/kspread.svg	pass	139600	57565	82035	0
svgs/oxygen-icons-5.113.0/scalable/apps/small/64x64/kwalletmanager.svg	pass	456812	116262	340550	0
svgs/oxygen-icons-5.113.0/scalable/apps/small/64x64/kword.svg	pass	1000534	392859	607675	0
svgs/oxygen-icons-5.113.0/scalable/apps/small/64x64/mameexecutor.svg	pass	347600	151431	196169	0
svgs/oxygen-icons-5.113.0/scalable/apps/small/64x64/preferences-desktop-notification-bell.svg	pass	29763	14968	14795	0
svgs/oxygen-icons-5.113.0/scalable/apps/small/64x64/qelectrotech.svg	pass	426594	131287	295307	0
svgs/oxygen-icons-5.113.0/scalable/apps/small/64x64/yakuake.svg	pass	177189	10554	166635	0
svgs/oxygen-icons-5.113.0/scalable/apps/step.svg	pass	62786	34782	28004	0
svgs/oxygen-icons-5.113.0/scalable/apps/strigi.svg	mismatch	54152	22506	31646	5
svgs/oxygen-icons-5.113.0/scalable/apps/system-diagnosis.svg	pass	118428	62924	55504	0
svgs/oxygen-icons-5.113.0/scalable/apps/system-file-manager.svg	pass	30847	17860	12987	0
svgs/oxygen-icons-5.113.0/scalable/apps/system-software-update.svg	pass	65863	27513	38350	0
svgs/oxygen-icons-5.113.0/scalable/apps/system-users.svg	pass	544175	84036	460139	0
svgs/oxygen-icons-5.113.0/scalable/apps/tagua.svg	pass	74381	36421	37960	0
svgs/oxygen-icons-5.113.0/scalable/apps/telepathy-kde.svg	pass	32695	14015	18680	0
svgs/oxygen-icons-5.113.0/scalable/apps/timevault.svg	mismatch	522067	167586	354481	5
svgs/oxygen-icons-5.113.0/scalable/apps/utilities-desktop-extra.svg	pass	60000	14874	45126	0
svgs/oxygen-icons-5.113.0/scalable/apps/utilities-file-archiver.svg	pass	274746	124343	150403	0
svgs/oxygen-icons-5.113.0/scalable/apps/utilities-log-viewer.svg	pass	285763	67480	218283	2
svgs/oxygen-icons-5.113.0/scalable/apps/utilities-system-monitor.svg	pass	71535	33591	37944	0
svgs/oxygen-icons-5.113.0/scalable/apps/utilities-terminal.svg	pass	116023	20825	95198	0
svgs/oxygen-icons-5.113.0/scalable/apps/wine.svg	pass	102974	48601	54373	0
svgs/oxygen-icons-5.113.0/scalable/apps/xorg.svg	pass	47650	24718	22932	0
svgs/oxygen-icons-5.113.0/scalable/apps/yakuake.svg	pass	176141	10576	165565	0
svgs/oxygen-icons-5.113.0/scalable/apps/zanshin.svg	pass	52467	26045	26422	0
svgs/oxygen-icons-5.113.0/scalable/categories/applications-accessories.svg	pass	71035	39358	31677	0
svgs/oxygen-icons-5.113.0/scalable/categories/applications-all.svg	pass	26709	9410	17299	0
svgs/oxygen-icons-5.113.0/scalable/categories/applications-development-translation.svg	pass	271337	149454	121883	0
svgs/oxygen-icons-5.113.0/scalable/categories/applications-development-web.svg	pass	127775	51792	75983	0
svgs/oxygen-icons-5.113.0/scalable/categories/applications-development.svg	pass	66199	42222	23977	0
svgs/oxygen-icons-5.113.0/scalable/categories/applications-education-language.svg	pass	182066	105232	76834	0
svgs/oxygen-icons-5.113.0/scalable/categories/applications-education-mathematics.svg	pass	23753	11707	12046	0
svgs/oxygen-icons-5.113.0/scalable/categories/applications-education-miscellaneous.svg	pass	10428	1840	8588	0
svgs/oxygen-icons-5.113.0/scalable/categories/applications-education-preschool.svg	mismatch	55506	17129	38377	28
svgs/oxygen-icons-5.113.0/scalable/categories/applications-education-school.svg	pass	479826	248589	231237	0
svgs/oxygen-icons-5.113.0/scalable/categories/applications-education-science.svg	pass	62703	30238	32465	0
svgs/oxygen-icons-5.113.0/scalable/categories/applications-education-university.svg	pass	58832	24557	34275	4
svgs/oxygen-icons-5.113.0/scalable/categories/applications-education.svg	pass	479826	248589	231237	0
svgs/oxygen-icons-5.113.0/scalable/categories/applications-engineering.svg	pass	34185	19648	14537	0
svgs/oxygen-icons-5.113.0/scalable/categories/applications-games.svg	pass	18792	11775	7017	1
svgs/oxygen-icons-5.113.0/scalable/categories/applications-graphics.svg	pass	193474	107892	85582	1
svgs/oxygen-icons-5.113.0/scalable/categories/applications-internet.svg	pass	671518	336804	334714	0
svgs/oxygen-icons-5.113.0/scalable/categories/applications-multimedia.svg	pass	56333	26144	30189	0
svgs/oxygen-icons-5.113.0/scalable/categories/applications-office.svg	pass	240287	88351	151936	0
svgs/oxygen-icons-5.113.0/scalable/categories/applications-other.svg	pass	258711	233956	24755	0
svgs/oxygen-icons-5.113.0/scalable/categories/applications-science.svg	pass	62703	30238	32465	0
svgs/oxygen-icons-5.113.0/scalable/categories/applications-system.svg	pass	18829	8330	10499	0
svgs/oxygen-icons-5.113.0/scalable/categories/applications-toys.svg	mismatch	55506	17129	38377	28
svgs/oxygen-icons-5.113.0/scalable/categories/applications-utilities.svg	pass	22970	8386	14584	0
svgs/oxygen-icons-5.113.0/scalable/categories/hidef/applications-all.svg	pass	30421	10690	19731	0
svgs/oxygen-icons-5.113.0/scalable/categories/hidef/applications-engineering.svg	pass	52519	23879	28640	1
svgs/oxygen-icons-5.113.0/scalable/categories/hidef/applications-graphics.svg	pass	186633	106456	80177	2
svgs/oxygen-icons-5.113.0/scalable/categories/hidef/applications-internet.svg	pass	646841	335797	311044	0
svgs/oxygen-icons-5.113.0/scalable/categories/hidef/applications-multimedia.svg	pass	57917	25256	32661	1
svgs/oxygen-icons-5.113.0/scalable/categories/hidef/applications-system.svg	pass	26875	10893	15982	0
svgs/oxygen-icons-5.113.0/scalable/categories/hidef/preferences-desktop.svg	pass	281164	151915	129249	0
svgs/oxygen-icons-5.113.0/scalable/categories/hidef/preferences-kde-connect.svg	pass	131372	29116	102256	0
svgs/oxygen-icons-5.113.0/scalable/categories/hidef/preferences-other.svg	pass	55206	29221	25985	0
svgs/oxygen-icons-5.113.0/scalable/categories/hidef/preferences-system-network.svg	pass	75886	28534	47352	0
svgs/oxygen-icons-5.113.0/scalable/categories/hidef/preferences-system.svg	mismatch	70050	38437	31613	6
svgs/oxygen-icons-5.113.0/scalable/categories/hidef/system-users.svg	pass	30238	16392	13846	0
svgs/oxygen-icons-5.113.0/scalable/categories/preferences-desktop-peripherals.svg	pass	93267	36325	56942	0
svgs/oxygen-icons-5.113.0/scalable/categories/preferences-desktop-personal.svg	pass	51470	32562	18908	0
svgs/oxygen-icons-5.113.0/scalable/categories/preferences-desktop-wallpaper.svg	pass	1300961	1174159	126802	0
svgs/oxygen-icons-5.113.0/scalable/categories/preferences-desktop.svg	pass	278572	152389	126183	0
svgs/oxygen-icons-5.113.0/scalable/categories/preferences-kde-connect.svg	pass	131491	29142	102349	0
svgs/oxygen-icons-5.113.0/scalable/categories/preferences-other.svg	pass	66786	28259	38527	0
svgs/oxygen-icons-5.113.0/scalable/categories/preferences-system-network.svg	pass	72275	27825	44450	0
svgs/oxygen-icons-5.113.0/scalable/categories/preferences-system.svg	mismatch	67617	37535	30082	6
svgs/oxygen-icons-5.113.0/scalable/categories/small/16x16/applications-all.svg	pass	25072	7285	17787	0
svgs/oxygen-icons-5.113.0/scalable/categories/small/16x16/applications-all.svgz.2021_06_05_16_13_07.0.svg	pass	25244	7281	17963	0
svgs/oxygen-icons-5.113.0/scalable/categories/small/16x16/applications-internet.svg	pass	670021	336689	333332	0
svgs/oxygen-icons-5.113.0/scalable/categories/small/16x16/preferences-kde-connect.svg	pass	125431	26362	99069	1
svgs/oxygen-icons-5.113.0/scalable/categories/small/16x16/preferences-other.svg	pass	195679	41136	154543	0
svgs/oxygen-icons-5.113.0/scalable/categories/small/22x22/applications-accessories.svg	pass	72037	38727	33310	0
svgs/oxygen-icons-5.113.0/scalable/categories/small/22x22/applications-education.svg	pass	7327	3362	3965	0
svgs/oxygen-icons-5.113.0/scalable/categories/small/22x22/applications-engineering.svg	pass	38097	21997	16100	3
svgs/oxygen-icons-5.113.0/scalable/categories/small/22x22/applications-games.svg	pass	15556	5570	9986	0
svgs/oxygen-icons-5.113.0/scalable/categories/small/22x22/applications-internet.svg	pass	672623	336885	335738	0
svgs/oxygen-icons-5.113.0/scalable/categories/small/22x22/applications-office.svg	pass	26960	5984	20976	0
svgs/oxygen-icons-5.113.0/scalable/categories/small/22x22/applications-other.svg	pass	11587	5568	6019	0
svgs/oxygen-icons-5.113.0/scalable/categories/small/22x22/applications-system.svg	pass	22414	10252	12162	0
svgs/oxygen-icons-5.113.0/scalable/categories/small/22x22/applications-utilities.svg	pass	26297	7792	18505	0
svgs/oxygen-icons-5.113.0/scalable/categories/small/22x22/preferences-desktop-personal.svg	pass	166977	31278	135699	2
svgs/oxygen-icons-5.113.0/scalable/categories/small/22x22/preferences-kde-connect.svg	pass	127747	27690	100057	0
svgs/oxygen-icons-5.113.0/scalable/categories/small/22x22/preferences-other.svg	pass	195634	41178	154456	0
svgs/oxygen-icons-5.113.0/scalable/categories/small/22x22/system-help.svg	pass	8848	4233	4615	0
svgs/oxygen-icons-5.113.0/scalable/categories/small/24x24/preferences-kde-connect.svg	pass	127550	27612	99938	0
svgs/oxygen-icons-5.113.0/scalable/categories/small/32x32/applications-all.svg	pass	27652	8714	18938	0
svgs/oxygen-icons-5.113.0/scalable/categories/small/32x32/preferences-kde-connect.svg	pass	128075	28005	100070	0
svgs/oxygen-icons-5.113.0/scalable/categories/small/32x32/system-users.svg	pass	22373	11600	10773	0
svgs/oxygen-icons-5.113.0/scalable/categories/small/48x48/applications-all.svg	pass	27602	9571	18031	0
svgs/oxygen-icons-5.113.0/scalable/categories/small/48x48/preferences-kde-connect.svg	pass	130267	29553	100714	0
svgs/oxygen-icons-5.113.0/scalable/categories/small/64x64/applications-all.svg	pass	30317	10453	19864	0
svgs/oxygen-icons-5.113.0/scalable/categories/small/64x64/preferences-kde-connect.svg	pass	131478	29032	102446	0
svgs/oxygen-icons-5.113.0/scalable/categories/system-help.svg	pass	8636	4235	4401	0
svgs/oxygen-icons-5.113.0/scalable/categories/system-users.svg	pass	26889	14304	12585	0
svgs/oxygen-icons-5.113.0/scalable/devices/audio-card.svg	mismatch	174968	92673	82295	17
svgs/oxygen-icons-5.113.0/scalable/devices/audio-headphones.svg	pass	77954	41915	36039	0
svgs/oxygen-icons-5.113.0/scalable/devices/audio-headset.svg	pass	92964	50731	42233	0
svgs/oxygen-icons-5.113.0/scalable/devices/audio-input-line.svg	pass	19871	9692	10179	0
svgs/oxygen-icons-5.113.0/scalable/devices/audio-input-microphone.svg	pass	179000	60327	118673	0
svgs/oxygen-icons-5.113.0/scalable/devices/battery.svg	mismatch	302812	31241	271571	20
svgs/oxygen-icons-5.113.0/scalable/devices/camera-photo.svg	pass	69997	32899	37098	0
svgs/oxygen-icons-5.113.0/scalable/devices/camera-web.svg	mismatch	35806	18971	16835	7
svgs/oxygen-icons-5.113.0/scalable/devices/computer-laptop.svg	pass	4235262	3769365	465897	0
svgs/oxygen-icons-5.113.0/scalable/devices/computer.svg	pass	158687	82433	76254	0
svgs/oxygen-icons-5.113.0/scalable/devices/cpu.svg	mismatch	254458	177265	77193	16
svgs/oxygen-icons-5.113.0/scalable/devices/drive-harddisk.svg	pass	59260	36891	22369	0
svgs/oxygen-icons-5.113.0/scalable/devices/drive-optical.svg	pass	229918	121514	108404	0
svgs/oxygen-icons-5.113.0/scalable/devices/drive-removable-media-usb-pendrive.svg	pass	79322	10722	68600	0
svgs/oxygen-icons-5.113.0/scalable/devices/drive-removable-media-usb.svg	pass	20722	11845	8877	0
svgs/oxygen-icons-5.113.0/scalable/devices/drive-removable-media.svg	pass	15770	8950	6820	0
svgs/oxygen-icons-5.113.0/scalable/devices/hidef/audio-card.svg	pass	255470	88201	167269	0
svgs/oxygen-icons-5.113.0/scalable/devices/hidef/camera-photo.svg	pass	3753273	2185500	1567773	1
svgs/oxygen-icons-5.113.0/scalable/devices/hidef/computer.svg	pass	122993	68558	54435	0
svgs/oxygen-icons-5.113.0/scalable/devices/hidef/input-keyboard.svg	mismatch	288711	207560	81151	10
svgs/oxygen-icons-5.113.0/scalable/devices/hidef/input-mouse.svg	pass	44264	14224	30040	0
svgs/oxygen-icons-5.113.0/scalable/devices/hidef/media-flash-sd-mmc.svg	pass	852932	158373	694559	0
svgs/oxygen-icons-5.113.0/scalable/devices/hidef/media-flash-smart-media.svg	pass	230371	122087	108284	2
svgs/oxygen-icons-5.113.0/scalable/devices/hidef/media-floppy.svg	pass	1267770	853090	414680	0
svgs/oxygen-icons-5.113.0/scalable/devices/hidef/media-optical-audio.svg	mismatch	846451	136242	710209	118
svgs/oxygen-icons-5.113.0/scalable/devices/hidef/media-optical-blu-ray.svg	pass	41350	22245	19105	0
svgs/oxygen-icons-5.113.0/scalable/devices/hidef/media-optical-data.svg	pass	412541	166577	245964	0
svgs/oxygen-icons-5.113.0/scalable/devices/hidef/media-optical-dvd-data.svg	pass	301690	150543	151147	0
svgs/oxygen-icons-5.113.0/scalable/devices/hidef/media-optical-dvd-video.svg	mismatch	1284143	381071	903072	7
svgs/oxygen-icons-5.113.0/scalable/devices/hidef/media-optical-dvd.svg	pass	32818	16839	15979	0
svgs/oxygen-icons-5.113.0/scalable/devices/hidef/media-optical-mixed-cd.svg	pass	1125788	211116	914672	0
svgs/oxygen-icons-5.113.0/scalable/devices/hidef/media-optical-recordable.svg	pass	28294	13926	14368	0
svgs/oxygen-icons-5.113.0/scalable/devices/hidef/media-optical-video.svg	mismatch	1262923	377145	885778	7
svgs/oxygen-icons-5.113.0/scalable/devices/hidef/media-optical.svg	pass	27265	13360	13905	0
svgs/oxygen-icons-5.113.0/scalable/devices/hidef/network-wired.svg	pass	213966	125680	88286	0
svgs/oxygen-icons-5.113.0/scalable/devices/hidef/printer-laser.svg	pass	184085	142456	41629	0
svgs/oxygen-icons-5.113.0/scalable/devices/hidef/printer.svg	pass	343287	205886	137401	0
svgs/oxygen-icons-5.113.0/scalable/devices/hidef/secure-card.svg	pass	1481774	619069	862705	4
svgs/oxygen-icons-5.113.0/scalable/devices/hidef/smartphone.svg	pass	519037	255442	263595	0
svgs/oxygen-icons-5.113.0/scalable/devices/hidef/tablet.svg	pass	348680	237931	110749	0
svgs/oxygen-icons-5.113.0/scalable/devices/hidef/video-display.svg	pass	1314817	1175294	139523	0
svgs/oxygen-icons-5.113.0/scalable/devices/input-gaming.svg	pass	92026	50129	41897	0
svgs/oxygen-icons-5.113.0/scalable/devices/input-keyboard.svg	mismatch	175376	96788	78588	8
svgs/oxygen-icons-5.113.0/scalable/devices/input-mouse.svg	pass	40945	13962	26983	0
svgs/oxygen-icons-5.113.0/scalable/devices/input-tablet.svg	pass	68035	22317	45718	0
svgs/oxygen-icons-5.113.0/scalable/devices/media-flash-memory-stick.svg	pass	134437	115726	18711	0
svgs/oxygen-icons-5.113.0/scalable/devices/media-flash-sd-mmc.svg	pass	850938	157477	693461	0
svgs/oxygen-icons-5.113.0/scalable/devices/media-flash-smart-media.svg	pass	114509	12509	102000	0
svgs/oxygen-icons-5.113.0/scalable/devices/media-flash.svg	pass	181230	143048	38182	0
svgs/oxygen-icons-5.113.0/scalable/devices/media-floppy.svg	pass	1161169	747500	413669	0
svgs/oxygen-icons-5.113.0/scalable/devices/media-optical-audio.svg	mismatch	847327	136812	710515	18
svgs/oxygen-icons-5.113.0/scalable/devices/media-optical-blu-ray.svg	pass	51238	22262	28976	0
svgs/oxygen-icons-5.113.0/scalable/devices/media-optical-data.svg	pass	253824	55707	198117	0
svgs/oxygen-icons-5.113.0/scalable/devices/media-optical-dvd-video.svg	mismatch	1259190	369028	890162	52
svgs/oxygen-icons-5.113.0/scalable/devices/media-optical-dvd.svg	pass	32717	16741	15976	0
svgs/oxygen-icons-5.113.0/scalable/devices/media-optical-mixed-cd.svg	pass	1052812	161923	890889	0
svgs/oxygen-icons-5.113.0/scalable/devices/media-optical-recordable.svg	pass	29379	14974	14405	0
svgs/oxygen-icons-5.113.0/scalable/devices/media-optical-video.svg	mismatch	1242266	365771	876495	52
svgs/oxygen-icons-5.113.0/scalable/devices/media-optical.svg	pass	28656	14252	14404	0
svgs/oxygen-icons-5.113.0/scalable/devices/media-tape.svg	pass	30049	16561	13488	0
svgs/oxygen-icons-5.113.0/scalable/devices/modem.svg	pass	54961	29410	25551	0
svgs/oxygen-icons-5.113.0/scalable/devices/multimedia-player-apple-ipod.svg	pass	24048	10970	13078	0
svgs/oxygen-icons-5.113.0/scalable/devices/multimedia-player.svg	pass	63126	28038	35088	3
svgs/oxygen-icons-5.113.0/scalable/devices/network-wired.svg	pass	90300	16486	73814	0
svgs/oxygen-icons-5.113.0/scalable/devices/network-wireless-connected-00.svg	pass	18941	6604	12337	0
svgs/oxygen-icons-5.113.0/scalable/devices/network-wireless-connected-100.svg	pass	56252	19723	36529	0
svgs/oxygen-icons-5.113.0/scalable/devices/network-wireless-connected-25.svg	pass	22376	10493	11883	0
svgs/oxygen-icons-5.113.0/scalable/devices/network-wireless-connected-50.svg	pass	27965	13427	14538	0
svgs/oxygen-icons-5.113.0/scalable/devices/network-wireless-connected-75.svg	pass	33086	16396	16690	0
svgs/oxygen-icons-5.113.0/scalable/devices/network-wireless-disconnected.svg	pass	15517	6601	8916	0
svgs/oxygen-icons-5.113.0/scalable/devices/network-wireless.svg	pass	56252	19723	36529	0
svgs/oxygen-icons-5.113.0/scalable/devices/pda.svg	pass	43406	22288	21118	0
svgs/oxygen-icons-5.113.0/scalable/devices/phone.svg	pass	375802	107354	268448	0
svgs/oxygen-icons-5.113.0/scalable/devices/printer-laser.svg	pass	40624	18948	21676	0
svgs/oxygen-icons-5.113.0/scalable/devices/printer.svg	pass	324517	190583	133934	0
svgs/oxygen-icons-5.113.0/scalable/devices/scanner.svg	mismatch	59574	22421	37153	43
svgs/oxygen-icons-5.113.0/scalable/devices/secure-card.svg	pass	1478109	618560	859549	0
svgs/oxygen-icons-5.113.0/scalable/devices/small/16x16/audio-headphones.svg	pass	78346	42019	36327	0
svgs/oxygen-icons-5.113.0/scalable/devices/small/16x16/audio-headset.svg	pass	28885	10605	18280	0
svgs/oxygen-icons-5.113.0/scalable/devices/small/16x16/audio-input-line.svg	pass	25959	13295	12664	0
svgs/oxygen-icons-5.113.0/scalable/devices/small/16x16/audio-input-microphone.svg	pass	69507	8918	60589	0
svgs/oxygen-icons-5.113.0/scalable/devices/small/16x16/battery.svg	pass	308013	29441	278572	0
svgs/oxygen-icons-5.113.0/scalable/devices/small/16x16/camera-photo.svg	pass	15190	7022	8168	0
svgs/oxygen-icons-5.113.0/scalable/devices/small/16x16/computer-laptop.svg	pass	1288265	1146133	142132	0
svgs/oxygen-icons-5.113.0/scalable/devices/small/16x16/computer.svg	pass	155339	78376	76963	0
svgs/oxygen-icons-5.113.0/scalable/devices/small/16x16/drive-harddisk.svg	pass	99921	29544	70377	0
svgs/oxygen-icons-5.113.0/scalable/devices/small/16x16/drive-optical.svg	pass	228286	115994	112292	0
svgs/oxygen-icons-5.113.0/scalable/devices/small/16x16/drive-removable-media-usb-pendrive.svg	pass	82593	7402	75191	2
svgs/oxygen-icons-5.113.0/scalable/devices/small/16x16/drive-removable-media.svg	pass	95946	5090	90856	0
svgs/oxygen-icons-5.113.0/scalable/devices/small/16x16/input-gaming.svg	pass	69411	30631	38780	0
svgs/oxygen-icons-5.113.0/scalable/devices/small/16x16/input-keyboard.svg	pass	80473	3135	77338	0
svgs/oxygen-icons-5.113.0/scalable/devices/small/16x16/input-mouse.svg	pass	30329	13339	16990	0
svgs/oxygen-icons-5.113.0/scalable/devices/small/16x16/input-tablet.svg	pass	68282	12564	55718	0
svgs/oxygen-icons-5.113.0/scalable/devices/small/16x16/media-flash-memory-stick.svg	pass	28838	6217	22621	0
svgs/oxygen-icons-5.113.0/scalable/devices/small/16x16/media-flash-sd-mmc.svg	pass	850567	155956	694611	0
svgs/oxygen-icons-5.113.0/scalable/devices/small/16x16/media-flash-smart-media.svg	pass	120660	9389	111271	0
svgs/oxygen-icons-5.113.0/scalable/devices/small/16x16/media-flash.svg	pass	97676	34696	62980	0
svgs/oxygen-icons-5.113.0/scalable/devices/small/16x16/media-floppy.svg	pass	1167176	747895	419281	0
svgs/oxygen-icons-5.113.0/scalable/devices/small/16x16/media-optical-audio.svg	mismatch	49695	27114	22581	15
svgs/oxygen-icons-5.113.0/scalable/devices/small/16x16/media-optical-data.svg	pass	30215	14064	16151	0
svgs/oxygen-icons-5.113.0/scalable/devices/small/16x16/media-optical-dvd.svg	pass	32692	13825	18867	0
svgs/oxygen-icons-5.113.0/scalable/devices/small/16x16/media-optical-mixed-cd.svg	pass	46619	22738	23881	0
svgs/oxygen-icons-5.113.0/scalable/devices/small/16x16/media-optical-recordable.svg	pass	28178	12999	15179	0
svgs/oxygen-icons-5.113.0/scalable/devices/small/16x16/media-optical-video.svg	pass	55265	22814	32451	0
svgs/oxygen-icons-5.113.0/scalable/devices/small/16x16/media-optical.svg	pass	839222	120713	718509	0
svgs/oxygen-icons-5.113.0/scalable/devices/small/16x16/media-tape.svg	pass	31242	17231	14011	0
svgs/oxygen-icons-5.113.0/scalable/devices/small/16x16/multimedia-player-apple-ipod.svg	pass	19848	9878	9970	0
svgs/oxygen-icons-5.113.0/scalable/devices/small/16x16/multimedia-player.svg	pass	34809	9789	25020	0
svgs/oxygen-icons-5.113.0/scalable/devices/small/16x16/network-wireless.svg	pass	34414	13325	21089	0
svgs/oxygen-icons-5.113.0/scalable/devices/small/16x16/pda.svg	pass	33461	12937	20524	1
svgs/oxygen-icons-5.113.0/scalable/devices/small/16x16/phone.svg	pass	10598	4405	6193	0
svgs/oxygen-icons-5.113.0/scalable/devices/small/16x16/printer.svg	pass	333908	200484	133424	0
svgs/oxygen-icons-5.113.0/scalable/devices/small/16x16/secure-card.svg	pass	898570	456826	441744	0
svgs/oxygen-icons-5.113.0/scalable/devices/small/16x16/smartphone.svg	pass	518878	252975	265903	1
svgs/oxygen-icons-5.113.0/scalable/devices/small/16x16/tablet.svg	pass	340077	230240	109837	0
svgs/oxygen-icons-5.113.0/scalable/devices/small/16x16/video-display.svg	pass	1304432	1164432	140000	0
svgs/oxygen-icons-5.113.0/scalable/devices/small/16x16/video-television.svg	pass	24505	6166	18339	0
svgs/oxygen-icons-5.113.0/scalable/devices/small/22x22/audio-headset.svg	pass	85841	45461	40380	0
svgs/oxygen-icons-5.113.0/scalable/devices/small/22x22/audio-input-line.svg	pass	24938	12092	12846	0
svgs/oxygen-icons-5.113.0/scalable/devices/small/22x22/audio-input-microphone.svg	pass	77129	11656	65473	0
svgs/oxygen-icons-5.113.0/scalable/devices/small/22x22/battery.svg	pass	308013	29441	278572	0
svgs/oxygen-icons-5.113.0/scalable/devices/small/22x22/camera-photo.svg	pass	15240	7106	8134	0
svgs/oxygen-icons-5.113.0/scalable/devices/small/22x22/computer-laptop.svg	pass	1306806	1159726	147080	0
svgs/oxygen-icons-5.113.0/scalable/devices/small/22x22/computer.svg	pass	131777	79761	52016	0
svgs/oxygen-icons-5.113.0/scalable/devices/small/22x22/drive-optical.svg	pass	228014	120310	107704	0
svgs/oxygen-icons-5.113.0/scalable/devices/small/22x22/input-gaming.svg	pass	80227	42389	37838	0
svgs/oxygen-icons-5.113.0/scalable/devices/small/22x22/input-mouse.svg	pass	33560	15339	18221	0
svgs/oxygen-icons-5.113.0/scalable/devices/small/22x22/media-flash-sd-mmc.svg	pass	481799	7717	474082	0
svgs/oxygen-icons-5.113.0/scalable/devices/small/22x22/media-floppy.svg	pass	570587	23991	546596	0
svgs/oxygen-icons-5.113.0/scalable/devices/small/22x22/media-optical-audio.svg	mismatch	49706	27114	22592	15
svgs/oxygen-icons-5.113.0/scalable/devices/small/22x22/media-optical-data.svg	pass	39219	16181	23038	0
svgs/oxygen-icons-5.113.0/scalable/devices/small/22x22/media-optical-dvd.svg	pass	32387	13802	18585	0
svgs/oxygen-icons-5.113.0/scalable/devices/small/22x22/media-optical-mixed-cd.svg	pass	59626	31725	27901	0
svgs/oxygen-icons-5.113.0/scalable/devices/small/22x22/media-optical-video.svg	pass	55694	23248	32446	0
svgs/oxygen-icons-5.113.0/scalable/devices/small/22x22/multimedia-player-apple-ipod.svg	pass	21915	10962	10953	0
svgs/oxygen-icons-5.113.0/scalable/devices/small/22x22/network-wireless-acquiring.svg	pass	82064	26600	55464	0
svgs/oxygen-icons-5.113.0/scalable/devices/small/22x22/network-wireless-connected-00.svg	pass	46678	4870	41808	0
svgs/oxygen-icons-5.113.0/scalable/devices/small/22x22/network-wireless-connected-100.svg	pass	62362	13529	48833	0
svgs/oxygen-icons-5.113.0/scalable/devices/small/22x22/network-wireless-connected-25.svg	pass	51439	7975	43464	0
svgs/oxygen-icons-5.113.0/scalable/devices/small/22x22/network-wireless-connected-50.svg	pass	54030	8172	45858	0
svgs/oxygen-icons-5.113.0/scalable/devices/small/22x22/network-wireless-connected-75.svg	pass	57075	10162	46913	0
svgs/oxygen-icons-5.113.0/scalable/devices/small/22x22/network-wireless-connected-alternativ-0.svg	pass	44106	2425	41681	0
svgs/oxygen-icons-5.113.0/scalable/devices/small/22x22/network-wireless-connected-alternativ-100.svg	pass	48678	4411	44267	0
svgs/oxygen-icons-5.113.0/scalable/devices/small/22x22/network-wireless-connected-alternativ-25.svg	pass	44945	3342	41603	0
svgs/oxygen-icons-5.113.0/scalable/devices/small/22x22/network-wireless-connected-alternativ-50.svg	pass	46060	3865	42195	0
svgs/oxygen-icons-5.113.0/scalable/devices/small/22x22/network-wireless-connected-alternativ-75.svg	pass	10388	3007	7381	0
svgs/oxygen-icons-5.113.0/scalable/devices/small/22x22/network-wireless-disconnected.svg	pass	51128	4760	46368	0
svgs/oxygen-icons-5.113.0/scalable/devices/small/22x22/network-wireless.svg	pass	62348	13529	48819	0
svgs/oxygen-icons-5.113.0/scalable/devices/small/22x22/phone.svg	pass	15288	6661	8627	0
svgs/oxygen-icons-5.113.0/scalable/devices/small/22x22/preferences-desktop-screensaver.svg	pass	71173	25420	45753	0
svgs/oxygen-icons-5.113.0/scalable/devices/small/22x22/printer.svg	pass	339291	203565	135726	0
svgs/oxygen-icons-5.113.0/scalable/devices/small/22x22/secure-card.svg	pass	1020131	458929	561202	0
svgs/oxygen-icons-5.113.0/scalable/devices/small/22x22/smartphone.svg	pass	515849	253306	262543	0
svgs/oxygen-icons-5.113.0/scalable/devices/small/22x22/tablet.svg	pass	340191	230405	109786	0
svgs/oxygen-icons-5.113.0/scalable/devices/small/22x22/video-display.svg	pass	1304504	1164465	140039	0
svgs/oxygen-icons-5.113.0/scalable/devices/small/32x32/audio-headphones.svg	pass	78202	41945	36257	0
svgs/oxygen-icons-5.113.0/scalable/devices/small/32x32/camera-photo.svg	pass	69969	33745	36224	0
svgs/oxygen-icons-5.113.0/scalable/devices/small/32x32/computer-laptop.svg	pass	2723203	2476716	246487	0
svgs/oxygen-icons-5.113.0/scalable/devices/small/32x32/computer.svg	pass	158745	82470	76275	0
svgs/oxygen-icons-5.113.0/scalable/devices/small/32x32/drive-optical.svg	pass	227494	119930	107564	0
svgs/oxygen-icons-5.113.0/scalable/devices/small/32x32/media-flash-sd-mmc.svg	pass	852066	157938	694128	0
svgs/oxygen-icons-5.113.0/scalable/devices/small/32x32/media-floppy.svg	pass	1167505	748121	419384	0
svgs/oxygen-icons-5.113.0/scalable/devices/small/32x32/media-optical-audio.svg	mismatch	49691	27107	22584	15
svgs/oxygen-icons-5.113.0/scalable/devices/small/32x32/media-optical-blu-ray.svg	pass	43918	16298	27620	0
svgs/oxygen-icons-5.113.0/scalable/devices/small/32x32/media-optical-data.svg	pass	40136	16586	23550	0
svgs/oxygen-icons-5.113.0/scalable/devices/small/32x32/media-optical-dvd-video.svg	pass	52086	27186	24900	1
svgs/oxygen-icons-5.113.0/scalable/devices/small/32x32/media-optical-dvd.svg	pass	33223	16007	17216	0
svgs/oxygen-icons-5.113.0/scalable/devices/small/32x32/media-optical-mixed-cd.svg	pass	59814	31881	27933	0
svgs/oxygen-icons-5.113.0/scalable/devices/small/32x32/media-optical-recordable.svg	pass	28317	13338	14979	0
svgs/oxygen-icons-5.113.0/scalable/devices/small/32x32/media-optical-video.svg	pass	47140	23804	23336	0
svgs/oxygen-icons-5.113.0/scalable/devices/small/32x32/media-optical.svg	pass	26781	12627	14154	0
svgs/oxygen-icons-5.113.0/scalable/devices/small/32x32/multimedia-player-ipod.svg	pass	21731	10838	10893	0
svgs/oxygen-icons-5.113.0/scalable/devices/small/32x32/network-wireless-acquiring.svg	pass	87470	35460	52010	0
svgs/oxygen-icons-5.113.0/scalable/devices/small/32x32/network-wireless-connected-00.svg	pass	50171	8426	41745	0
svgs/oxygen-icons-5.113.0/scalable/devices/small/32x32/network-wireless-connected-100.svg	pass	64914	22369	42545	0
svgs/oxygen-icons-5.113.0/scalable/devices/small/32x32/network-wireless-connected-25.svg	pass	57867	13413	44454	0
svgs/oxygen-icons-5.113.0/scalable/devices/small/32x32/network-wireless-connected-50.svg	pass	65086	17314	47772	0
svgs/oxygen-icons-5.113.0/scalable/devices/small/32x32/network-wireless-connected-75.svg	pass	70208	20702	49506	0
svgs/oxygen-icons-5.113.0/scalable/devices/small/32x32/network-wireless-disconnected.svg	pass	49893	8418	41475	0
svgs/oxygen-icons-5.113.0/scalable/devices/small/32x32/network-wireless.svg	pass	64914	22369	42545	0
svgs/oxygen-icons-5.113.0/scalable/devices/small/32x32/phone.svg	pass	22882	12290	10592	0
svgs/oxygen-icons-5.113.0/scalable/devices/small/32x32/printer-laser.svg	pass	32999	14217	18782	0
svgs/oxygen-icons-5.113.0/scalable/devices/small/32x32/printer.svg	pass	340074	202492	137582	0
svgs/oxygen-icons-5.113.0/scalable/devices/small/32x32/secure-card.svg	pass	1461099	606574	854525	0
svgs/oxygen-icons-5.113.0/scalable/devices/small/32x32/smartphone.svg	pass	515918	253532	262386	0
svgs/oxygen-icons-5.113.0/scalable/devices/small/32x32/tablet.svg	pass	348143	238487	109656	0
svgs/oxygen-icons-5.113.0/scalable/devices/small/32x32/video-display.svg	pass	1321815	1176197	145618	0
svgs/oxygen-icons-5.113.0/scalable/devices/small/48x48/computer-laptop.svg	pass	2732458	2484106	248352	0
svgs/oxygen-icons-5.113.0/scalable/devices/small/48x48/computer.svg	pass	136498	82636	53862	0
svgs/oxygen-icons-5.113.0/scalable/devices/small/48x48/media-flash-sd-mmc.svg	pass	167127	157422	9705	0
svgs/oxygen-icons-5.113.0/scalable/devices/small/48x48/media-floppy.svg	pass	1167494	747696	419798	0
svgs/oxygen-icons-5.113.0/scalable/devices/small/48x48/media-optical-audio.svg	mismatch	50940	28759	22181	15
svgs/oxygen-icons-5.113.0/scalable/devices/small/48x48/media-optical-blu-ray.svg	pass	52775	19807	32968	0
svgs/oxygen-icons-5.113.0/scalable/devices/small/48x48/media-optical-data.svg	pass	59109	29431	29678	0
svgs/oxygen-icons-5.113.0/scalable/devices/small/48x48/media-optical-dvd-video.svg	pass	310997	261727	49270	0
svgs/oxygen-icons-5.113.0/scalable/devices/small/48x48/media-optical-dvd.svg	pass	42407	18152	24255	0
svgs/oxygen-icons-5.113.0/scalable/devices/small/48x48/media-optical-mixed-cd.svg	pass	67887	38215	29672	0
svgs/oxygen-icons-5.113.0/scalable/devices/small/48x48/media-optical-recordable.svg	pass	29275	14997	14278	0
svgs/oxygen-icons-5.113.0/scalable/devices/small/48x48/media-optical-video.svg	pass	299582	257854	41728	0
svgs/oxygen-icons-5.113.0/scalable/devices/small/48x48/media-optical.svg	pass	28025	14285	13740	0
svgs/oxygen-icons-5.113.0/scalable/devices/small/48x48/network-wireless-connected-00.svg	pass	18167	6948	11219	0
svgs/oxygen-icons-5.113.0/scalable/devices/small/48x48/network-wireless-connected-25.svg	pass	27578	11771	15807	0
svgs/oxygen-icons-5.113.0/scalable/devices/small/48x48/network-wireless-connected-50.svg	pass	35375	15642	19733	0
svgs/oxygen-icons-5.113.0/scalable/devices/small/48x48/network-wireless-connected-75.svg	pass	50360	18830	31530	0
svgs/oxygen-icons-5.113.0/scalable/devices/small/48x48/network-wireless-disconnected.svg	pass	18172	6952	11220	0
svgs/oxygen-icons-5.113.0/scalable/devices/small/48x48/network-wireless.svg	pass	62956	22232	40724	0
svgs/oxygen-icons-5.113.0/scalable/devices/small/48x48/printer-laser.svg	pass	36518	18290	18228	0
svgs/oxygen-icons-5.113.0/scalable/devices/small/48x48/printer.svg	pass	323403	189345	134058	0
svgs/oxygen-icons-5.113.0/scalable/devices/small/48x48/secure-card.svg	pass	1476693	618310	858383	0
svgs/oxygen-icons-5.113.0/scalable/devices/small/48x48/smartphone.svg	pass	516403	253902	262501	0
svgs/oxygen-icons-5.113.0/scalable/devices/small/48x48/tablet.svg	pass	348030	238460	109570	0
svgs/oxygen-icons-5.113.0/scalable/devices/small/48x48/video-display.svg	pass	1321879	1176199	145680	0
svgs/oxygen-icons-5.113.0/scalable/devices/small/64x64/camera-photo.svg	pass	69897	33681	36216	0
svgs/oxygen-icons-5.113.0/scalable/devices/small/64x64/computer-laptop.svg	pass	2912396	2597840	314556	0
svgs/oxygen-icons-5.113.0/scalable/devices/small/64x64/computer.svg	pass	158867	82507	76360	0
svgs/oxygen-icons-5.113.0/scalable/devices/small/64x64/media-flash-sd-mmc.svg	pass	632715	156230	476485	0
svgs/oxygen-icons-5.113.0/scalable/devices/small/64x64/media-floppy.svg	pass	1168060	747693	420367	0
svgs/oxygen-icons-5.113.0/scalable/devices/small/64x64/media-optical-dvd-video.svg	mismatch	329778	275916	53862	53
svgs/oxygen-icons-5.113.0/scalable/devices/small/64x64/media-optical-dvd.svg	pass	32118	16308	15810	0
svgs/oxygen-icons-5.113.0/scalable/devices/small/64x64/network-wireless-connected-100.svg	pass	61766	21775	39991	0
svgs/oxygen-icons-5.113.0/scalable/devices/small/64x64/network-wireless-connected-25.svg	pass	23659	10780	12879	0
svgs/oxygen-icons-5.113.0/scalable/devices/small/64x64/network-wireless-connected-50.svg	pass	29355	13773	15582	0
svgs/oxygen-icons-5.113.0/scalable/devices/small/64x64/network-wireless-connected-75.svg	pass	34383	16761	17622	0
svgs/oxygen-icons-5.113.0/scalable/devices/small/64x64/network-wireless.svg	pass	61766	21775	39991	0
svgs/oxygen-icons-5.113.0/scalable/devices/small/64x64/printer-laser.svg	pass	35317	17421	17896	0
svgs/oxygen-icons-5.113.0/scalable/devices/small/64x64/printer.svg	pass	324159	190123	134036	0
svgs/oxygen-icons-5.113.0/scalable/devices/small/64x64/smartphone.svg	pass	516860	254097	262763	0
svgs/oxygen-icons-5.113.0/scalable/devices/small/64x64/tablet.svg	pass	348095	238577	109518	0
svgs/oxygen-icons-5.113.0/scalable/devices/small/64x64/video-display.svg	pass	1314470	1173606	140864	0
svgs/oxygen-icons-5.113.0/scalable/devices/smartphone.svg	pass	518487	255298	263189	0
svgs/oxygen-icons-5.113.0/scalable/devices/tablet.svg	pass	347836	238378	109458	0
svgs/oxygen-icons-5.113.0/scalable/devices/tools-media-optical-format.svg	pass	60875	32875	28000	0
svgs/oxygen-icons-5.113.0/scalable/devices/video-display.svg	pass	1314595	1175329	139266	0
svgs/oxygen-icons-5.113.0/scalable/devices/video-projector.svg	pass	82986	37877	45109	0
svgs/oxygen-icons-5.113.0/scalable/devices/video-television.svg	pass	43744	13487	30257	0
svgs/oxygen-icons-5.113.0/scalable/emblems/emblem-encrypted-locked.svg	pass	11209	3649	7560	0
svgs/oxygen-icons-5.113.0/scalable/emblems/emblem-encrypted-unlocked.svg	pass	10499	3891	6608	0
svgs/oxygen-icons-5.113.0/scalable/emblems/emblem-favorite.svg	pass	15473	7963	7510	0
svgs/oxygen-icons-5.113.0/scalable/emblems/emblem-important.svg	pass	49760	4985	44775	0
svgs/oxygen-icons-5.113.0/scalable/emblems/emblem-locked.svg	pass	7614	2362	5252	0
svgs/oxygen-icons-5.113.0/scalable/emblems/emblem-mounted.svg	pass	13718	4544	9174	0
svgs/oxygen-icons-5.113.0/scalable/emblems/emblem-new.svg	pass	127667	19505	108162	0
svgs/oxygen-icons-5.113.0/scalable/emblems/emblem-symbolic-link.svg	pass	7041	2508	4533	0
svgs/oxygen-icons-5.113.0/scalable/emblems/emblem-unlocked.svg	pass	7530	2396	5134	0
svgs/oxygen-icons-5.113.0/scalable/emblems/emblem-unmounted.svg	pass	7731	2290	5441	0
svgs/oxygen-icons-5.113.0/scalable/emblems/image-has-versions-open.svg	pass	107703	3053	104650	0
svgs/oxygen-icons-5.113.0/scalable/emblems/image-has-versions.svg	pass	56185	2795	53390	0
svgs/oxygen-icons-5.113.0/scalable/emblems/image-stack-open.svg	pass	107451	2500	104951	0
svgs/oxygen-icons-5.113.0/scalable/emblems/image-stack.svg	pass	55947	2265	53682	0
svgs/oxygen-icons-5.113.0/scalable/emblems/small/16x16/emblem-encrypted-locked.svg	pass	12952	4842	8110	0
svgs/oxygen-icons-5.113.0/scalable/emblems/small/16x16/emblem-encrypted-unlocked.svg	pass	20452	5089	15363	0
svgs/oxygen-icons-5.113.0/scalable/emblems/small/16x16/emblem-important.svg	pass	49760	4985	44775	0
svgs/oxygen-icons-5.113.0/scalable/emblems/small/16x16/emblem-link.svg	pass	7118	2508	4610	0
svgs/oxygen-icons-5.113.0/scalable/emblems/small/16x16/emblem-locked.svg	pass	8382	2507	5875	0
svgs/oxygen-icons-5.113.0/scalable/emblems/small/16x16/emblem-mounted.svg	pass	8559	3287	5272	0
svgs/oxygen-icons-5.113.0/scalable/emblems/small/16x16/emblem-new.svg	pass	113695	19378	94317	0
svgs/oxygen-icons-5.113.0/scalable/emblems/small/16x16/emblem-unlocked.svg	pass	8283	2510	5773	0
svgs/oxygen-icons-5.113.0/scalable/emblems/small/16x16/emblem-unmounted.svg	pass	8605	2301	6304	0
svgs/oxygen-icons-5.113.0/scalable/emblems/small/16x16/gpg-key-trust-level-0.svg	pass	11659	4618	7041	0
svgs/oxygen-icons-5.113.0/scalable/emblems/small/16x16/gpg-key-trust-level-1.svg	pass	11635	4049	7586	0
svgs/oxygen-icons-5.113.0/scalable/emblems/small/16x16/gpg-key-trust-level-2.svg	pass	11900	4056	7844	0
svgs/oxygen-icons-5.113.0/scalable/emblems/small/16x16/gpg-key-trust-level-3.svg	pass	12106	4056	8050	0
svgs/oxygen-icons-5.113.0/scalable/emblems/small/16x16/gpg-key-trust-level-4.svg	pass	16408	5659	10749	0
svgs/oxygen-icons-5.113.0/scalable/emblems/small/16x16/image-has-versions-open.svg	pass	107196	2038	105158	0
svgs/oxygen-icons-5.113.0/scalable/emblems/small/16x16/image-has-versions.svg	pass	106171	1825	104346	0
svgs/oxygen-icons-5.113.0/scalable/emblems/small/16x16/image-stack-open.svg	pass	107171	2038	105133	0
svgs/oxygen-icons-5.113.0/scalable/emblems/small/16x16/image-stack.svg	pass	106204	1825	104379	0
svgs/oxygen-icons-5.113.0/scalable/emblems/small/16x16/vcs-added.svg	pass	11532	2112	9420	0
svgs/oxygen-icons-5.113.0/scalable/emblems/small/16x16/vcs-conflicting.svg	pass	16832	1975	14857	0
svgs/oxygen-icons-5.113.0/scalable/emblems/small/16x16/vcs-locally-modified-unstaged.svg	pass	12005	2382	9623	0
svgs/oxygen-icons-5.113.0/scalable/emblems/small/16x16/vcs-locally-modified.svg	pass	12145	2502	9643	0
svgs/oxygen-icons-5.113.0/scalable/emblems/small/16x16/vcs-normal.svg	pass	30655	2088	28567	0
svgs/oxygen-icons-5.113.0/scalable/emblems/small/16x16/vcs-removed.svg	pass	22227	2114	20113	0
svgs/oxygen-icons-5.113.0/scalable/emblems/small/16x16/vcs-update-required.svg	pass	16881	2427	14454	0
svgs/oxygen-icons-5.113.0/scalable/emblems/small/22x22/emblem-encrypted-locked.svg	pass	13609	3492	10117	0
svgs/oxygen-icons-5.113.0/scalable/emblems/small/22x22/emblem-encrypted-unlocked.svg	pass	15631	3436	12195	0
svgs/oxygen-icons-5.113.0/scalable/emblems/small/22x22/emblem-important.svg	pass	49512	5147	44365	0
svgs/oxygen-icons-5.113.0/scalable/emblems/small/22x22/emblem-link.svg	pass	7231	2656	4575	0
svgs/oxygen-icons-5.113.0/scalable/emblems/small/22x22/emblem-locked.svg	pass	11118	2709	8409	0
svgs/oxygen-icons-5.113.0/scalable/emblems/small/22x22/emblem-mounted.svg	pass	12820	3814	9006	0
svgs/oxygen-icons-5.113.0/scalable/emblems/small/22x22/emblem-new.svg	pass	128008	19565	108443	0
svgs/oxygen-icons-5.113.0/scalable/emblems/small/22x22/emblem-unlocked.svg	pass	10992	2652	8340	0
svgs/oxygen-icons-5.113.0/scalable/emblems/small/22x22/emblem-unmounted.svg	pass	10860	2466	8394	0
svgs/oxygen-icons-5.113.0/scalable/emblems/small/22x22/image-has-versions-open.svg	pass	55504	2272	53232	0
svgs/oxygen-icons-5.113.0/scalable/emblems/small/22x22/image-has-versions.svg	pass	57462	2781	54681	0
svgs/oxygen-icons-5.113.0/scalable/emblems/small/22x22/image-stack-open.svg	pass	55690	2272	53418	0
svgs/oxygen-icons-5.113.0/scalable/emblems/small/22x22/image-stack.svg	pass	55372	2337	53035	0
svgs/oxygen-icons-5.113.0/scalable/emblems/small/22x22/vcs-added.svg	pass	17510	2012	15498	0
svgs/oxygen-icons-5.113.0/scalable/emblems/small/22x22/vcs-conflicting.svg	pass	36333	2097	34236	0
svgs/oxygen-icons-5.113.0/scalable/emblems/small/22x22/vcs-locally-modified-unstaged.svg	pass	15106	2386	12720	0
svgs/oxygen-icons-5.113.0/scalable/emblems/small/22x22/vcs-locally-modified.svg	pass	15590	2699	12891	0
svgs/oxygen-icons-5.113.0/scalable/emblems/small/22x22/vcs-normal.svg	pass	53673	2408	51265	0
svgs/oxygen-icons-5.113.0/scalable/emblems/small/22x22/vcs-removed.svg	pass	23389	2392	20997	0
svgs/oxygen-icons-5.113.0/scalable/emblems/small/22x22/vcs-update-required.svg	pass	29783	4506	25277	0
svgs/oxygen-icons-5.113.0/scalable/emblems/small/8x8/emblem-checked.svg	pass	7598	782	6816	0
svgs/oxygen-icons-5.113.0/scalable/emblems/small/8x8/emblem-encrypted-locked.svg	pass	8702	2158	6544	0
svgs/oxygen-icons-5.113.0/scalable/emblems/small/8x8/emblem-encrypted-unlocked.svg	pass	9064	2357	6707	0
svgs/oxygen-icons-5.113.0/scalable/emblems/small/8x8/emblem-important.svg	pass	49457	4967	44490	0
svgs/oxygen-icons-5.113.0/scalable/emblems/small/8x8/emblem-link.svg	pass	6655	1418	5237	0
svgs/oxygen-icons-5.113.0/scalable/emblems/small/8x8/emblem-locked.svg	pass	6645	1230	5415	0
svgs/oxygen-icons-5.113.0/scalable/emblems/small/8x8/emblem-mounted.svg	pass	6347	1342	5005	0
svgs/oxygen-icons-5.113.0/scalable/emblems/small/8x8/emblem-pause.svg	pass	3801	730	3071	0
svgs/oxygen-icons-5.113.0/scalable/emblems/small/8x8/emblem-unlocked.svg	pass	6350	1086	5264	0
svgs/oxygen-icons-5.113.0/scalable/emblems/small/8x8/emblem-unmounted.svg	pass	6444	1034	5410	0
svgs/oxygen-icons-5.113.0/scalable/emblems/small/8x8/vcs-added.svg	pass	7205	604	6601	0
svgs/oxygen-icons-5.113.0/scalable/emblems/small/8x8/vcs-conflicting.svg	pass	7964	650	7314	0
svgs/oxygen-icons-5.113.0/scalable/emblems/small/8x8/vcs-locally-modified-unstaged.svg	pass	7827	731	7096	0
svgs/oxygen-icons-5.113.0/scalable/emblems/small/8x8/vcs-locally-modified.svg	pass	7531	805	6726	0
svgs/oxygen-icons-5.113.0/scalable/emblems/small/8x8/vcs-normal.svg	pass	7063	733	6330	0
svgs/oxygen-icons-5.113.0/scalable/emblems/small/8x8/vcs-removed.svg	pass	7672	733	6939	0
svgs/oxygen-icons-5.113.0/scalable/emblems/small/8x8/vcs-update-required.svg	pass	7835	809	7026	0
svgs/oxygen-icons-5.113.0/scalable/emblems/vcs-added.svg	pass	40414	4192	36222	0
svgs/oxygen-icons-5.113.0/scalable/emblems/vcs-conflicting.svg	pass	43213	4573	38640	0
svgs/oxygen-icons-5.113.0/scalable/emblems/vcs-locally-modified-unstaged.svg	pass	28899	2727	26172	2
svgs/oxygen-icons-5.113.0/scalable/emblems/vcs-locally-modified.svg	pass	28319	2428	25891	0
svgs/oxygen-icons-5.113.0/scalable/emblems/vcs-normal.svg	pass	8538	2176	6362	0
svgs/oxygen-icons-5.113.0/scalable/emblems/vcs-removed.svg	pass	26552	4154	22398	0
svgs/oxygen-icons-5.113.0/scalable/emblems/vcs-update-required.svg	pass	51839	2447	49392	0
svgs/oxygen-icons-5.113.0/scalable/emotes/emotes.svg	pass	359139	160123	199016	2
svgs/oxygen-icons-5.113.0/scalable/emotes/face-angel.svg	pass	30100	13790	16310	0
svgs/oxygen-icons-5.113.0/scalable/emotes/face-embarrassed.svg	pass	26651	10657	15994	0
svgs/oxygen-icons-5.113.0/scalable/emotes/face-kiss.svg	pass	65738	23415	42323	0
svgs/oxygen-icons-5.113.0/scalable/emotes/face-laugh.svg	pass	40774	20620	20154	0
svgs/oxygen-icons-5.113.0/scalable/emotes/face-plain.svg	pass	19766	8391	11375	0
svgs/oxygen-icons-5.113.0/scalable/emotes/face-raspberry.svg	pass	52440	16712	35728	0
svgs/oxygen-icons-5.113.0/scalable/emotes/face-sad.svg	pass	20820	8667	12153	0
svgs/oxygen-icons-5.113.0/scalable/emotes/face-smile-big.svg	pass	33778	14047	19731	0
svgs/oxygen-icons-5.113.0/scalable/emotes/face-smile.svg	pass	21433	10025	11408	0
svgs/oxygen-icons-5.113.0/scalable/emotes/face-surprise.svg	pass	26571	11898	14673	0
svgs/oxygen-icons-5.113.0/scalable/emotes/face-uncertain.svg	pass	23253	10708	12545	0
svgs/oxygen-icons-5.113.0/scalable/emotes/face-wink.svg	pass	38709	13956	24753	0
svgs/oxygen-icons-5.113.0/scalable/emotes/small/16x16/face-angel.svg	pass	30100	13790	16310	0
svgs/oxygen-icons-5.113.0/scalable/emotes/small/16x16/face-kiss.svg	pass	63166	21442	41724	0
svgs/oxygen-icons-5.113.0/scalable/emotes/small/16x16/face-laugh.svg	pass	55651	19363	36288	0
svgs/oxygen-icons-5.113.0/scalable/emotes/small/16x16/face-raspberry.svg	pass	59985	12969	47016	0
svgs/oxygen-icons-5.113.0/scalable/emotes/small/16x16/face-sad.svg	pass	20505	8659	11846	0
svgs/oxygen-icons-5.113.0/scalable/emotes/small/16x16/face-smile-big.svg	pass	37730	15715	22015	0
svgs/oxygen-icons-5.113.0/scalable/emotes/small/16x16/face-uncertain.svg	pass	30530	10672	19858	0
svgs/oxygen-icons-5.113.0/scalable/emotes/small/22x22/face-angel.svg	pass	27696	12508	15188	0
svgs/oxygen-icons-5.113.0/scalable/emotes/small/22x22/face-confused.svg	pass	30605	7045	23560	1
svgs/oxygen-icons-5.113.0/scalable/emotes/small/22x22/face-crying.svg	pass	30453	10767	19686	0
svgs/oxygen-icons-5.113.0/scalable/emotes/small/22x22/face-devilish.svg	pass	22050	9347	12703	0
svgs/oxygen-icons-5.113.0/scalable/emotes/small/22x22/face-embarrassed.svg	pass	18876	6983	11893	0
svgs/oxygen-icons-5.113.0/scalable/emotes/small/22x22/face-foot-in-mouth.svg	pass	28362	6607	21755	0
svgs/oxygen-icons-5.113.0/scalable/emotes/small/22x22/face-glasses.svg	pass	28911	12906	16005	0
svgs/oxygen-icons-5.113.0/scalable/emotes/small/22x22/face-kiss.svg	pass	63131	21385	41746	0
svgs/oxygen-icons-5.113.0/scalable/emotes/small/22x22/face-laugh.svg	pass	55500	19427	36073	0
svgs/oxygen-icons-5.113.0/scalable/emotes/small/22x22/face-plain.svg	pass	16622	5694	10928	0
svgs/oxygen-icons-5.113.0/scalable/emotes/small/22x22/face-raspberry.svg	pass	61899	12951	48948	0
svgs/oxygen-icons-5.113.0/scalable/emotes/small/22x22/face-sad.svg	pass	20509	8669	11840	0
svgs/oxygen-icons-5.113.0/scalable/emotes/small/22x22/face-sleep.svg	pass	19387	6855	12532	0
svgs/oxygen-icons-5.113.0/scalable/emotes/small/22x22/face-smile-big.svg	pass	37383	15377	22006	0
svgs/oxygen-icons-5.113.0/scalable/emotes/small/22x22/face-smile-gearhead-female.svg	pass	50476	16228	34248	0
svgs/oxygen-icons-5.113.0/scalable/emotes/small/22x22/face-smile-gearhead-male.svg	pass	68471	15905	52566	0
svgs/oxygen-icons-5.113.0/scalable/emotes/small/22x22/face-smile.svg	pass	17170	6147	11023	0
svgs/oxygen-icons-5.113.0/scalable/emotes/small/22x22/face-surprise.svg	pass	16703	5820	10883	0
svgs/oxygen-icons-5.113.0/scalable/emotes/small/22x22/face-uncertain.svg	pass	26402	9906	16496	0
svgs/oxygen-icons-5.113.0/scalable/emotes/small/22x22/face-wink.svg	pass	17585	6295	11290	0
svgs/oxygen-icons-5.113.0/scalable/mimetypes/application-epub+zip.svg	pass	2408632	1966655	441977	0
svgs/oxygen-icons-5.113.0/scalable/mimetypes/application-illustrator.svg	pass	70976	12542	58434	0
svgs/oxygen-icons-5.113.0/scalable/mimetypes/application-javascript.svg	pass	99690	22887	76803	0
svgs/oxygen-icons-5.113.0/scalable/mimetypes/application-msword-template.svg	pass	1657201	915854	741347	0
svgs/oxygen-icons-5.113.0/scalable/mimetypes/application-msword.svg	pass	1610582	906038	704544	0
svgs/oxygen-icons-5.113.0/scalable/mimetypes/application-octet-stream.svg	pass	268257	152175	116082	0
svgs/oxygen-icons-5.113.0/scalable/mimetypes/application-pdf.svg	pass	52854	9485	43369	0
svgs/oxygen-icons-5.113.0/scalable/mimetypes/application-pgp-encrypted.svg	pass	185526	22782	162744	0
svgs/oxygen-icons-5.113.0/scalable/mimetypes/application-pgp-keys.svg	pass	405316	80993	324323	1
svgs/oxygen-icons-5.113.0/scalable/mimetypes/application-pgp-signature.svg	pass	71065	22460	48605	0
svgs/oxygen-icons-5.113.0/scalable/mimetypes/application-pkcs7-mime.svg	pass	402706	81064	321642	0
svgs/oxygen-icons-5.113.0/scalable/mimetypes/application-pkcs7-signature.svg	pass	71065	22460	48605	0
svgs/oxygen-icons-5.113.0/scalable/mimetypes/application-postscript.svg	pass	121170	40693	80477	0
svgs/oxygen-icons-5.113.0/scalable/mimetypes/application-relaxng.svg	pass	1685920	603990	1081930	0
svgs/oxygen-icons-5.113.0/scalable/mimetypes/application-rss+xml.svg	pass	19514	9008	10506	0
svgs/oxygen-icons-5.113.0/scalable/mimetypes/application-rtf.svg	pass	332943	147607	185336	0
svgs/oxygen-icons-5.113.0/scalable/mimetypes/application-sxw.svg	pass	358130	177664	180466	0
svgs/oxygen-icons-5.113.0/scalable/mimetypes/application-vnd-google-earth-kml.svg	pass	65006	9925	55081	0
svgs/oxygen-icons-5.113.0/scalable/mimetypes/application-vnd.iccprofile.svg	pass	193841	53956	139885	0
svgs/oxygen-icons-5.113.0/scalable/mimetypes/application-vnd.ms-access.svg	pass	243006	64518	178488	0
svgs/oxygen-icons-5.113.0/scalable/mimetypes/application-vnd.ms-excel.svg	pass	94467	24713	69754	0
svgs/oxygen-icons-5.113.0/scalable/mimetypes/application-vnd.ms-powerpoint.svg	pass	212135	39052	173083	0
svgs/oxygen-icons-5.113.0/scalable/mimetypes/application-vnd.oasis.opendocument.chart.svg	pass	257068	66698	190370	1
svgs/oxygen-icons-5.113.0/scalable/mimetypes/application-vnd.oasis.opendocument.database.svg	pass	714235	172409	541826	0
svgs/oxygen-icons-5.113.0/scalable/mimetypes/application-vnd.oasis.opendocument.formula-template.svg	pass	385049	170615	214434	0
svgs/oxygen-icons-5.113.0/scalable/mimetypes/application-vnd.oasis.opendocument.formula.svg	pass	336433	162913	173520	0
svgs/oxygen-icons-5.113.0/scalable/mimetypes/application-vnd.oasis.opendocument.graphics.svg	pass	186069	36514	149555	0
svgs/oxygen-icons-5.113.0/scalable/mimetypes/application-vnd.oasis.opendocument.image.svg	pass	314727	118693	196034	0
svgs/oxygen-icons-5.113.0/scalable/mimetypes/application-vnd.oasis.opendocument.presentation-template.svg	pass	254642	42142	212500	0
svgs/oxygen-icons-5.113.0/scalable/mimetypes/application-vnd.oasis.opendocument.presentation.svg	pass	207440	36001	171439	0
svgs/oxygen-icons-5.113.0/scalable/mimetypes/application-vnd.oasis.opendocument.spreadsheet-template.svg	pass	125900	29273	96627	0
svgs/oxygen-icons-5.113.0/scalable/mimetypes/application-vnd.oasis.opendocument.spreadsheet.svg	pass	86189	22712	63477	0
svgs/oxygen-icons-5.113.0/scalable/mimetypes/application-vnd.oasis.opendocument.text.svg	pass	1569188	908022	661166	0
svgs/oxygen-icons-5.113.0/scalable/mimetypes/application-vnd.openxmlformats-officedocument.wordprocessingml.document.svg	pass	1569188	908022	661166	0
svgs/oxygen-icons-5.113.0/scalable/mimetypes/application-vnd.rn-realmedia.svg	pass	112565	33231	79334	0
svgs/oxygen-icons-5.113.0/scalable/mimetypes/application-vnd.scribus.svg	pass	568919	139880	429039	0
svgs/oxygen-icons-5.113.0/scalable/mimetypes/application-vnd.stardivision.calc.svg	pass	86189	22712	63477	0
svgs/oxygen-icons-5.113.0/scalable/mimetypes/application-vnd.stardivision.draw.svg	pass	314727	118693	196034	0
svgs/oxygen-icons-5.113.0/scalable/mimetypes/application-vnd.stardivision.mail.svg	pass	909212	427382	481830	3
svgs/oxygen-icons-5.113.0/scalable/mimetypes/application-vnd.stardivision.math.svg	pass	336433	162913	173520	0
svgs/oxygen-icons-5.113.0/scalable/mimetypes/application-vnd.sun.xml.calc.svg	pass	86189	22712	63477	0
svgs/oxygen-icons-5.113.0/scalable/mimetypes/application-vnd.sun.xml.calc.template.svg	pass	125900	29273	96627	0
svgs/oxygen-icons-5.113.0/scalable/mimetypes/application-vnd.sun.xml.draw.svg	pass	314727	118693	196034	0
svgs/oxygen-icons-5.113.0/scalable/mimetypes/application-vnd.sun.xml.draw.template.svg	pass	353471	126379	227092	0
svgs/oxygen-icons-5.113.0/scalable/mimetypes/application-vnd.sun.xml.math.svg	pass	336433	162913	173520	0
svgs/oxygen-icons-5.113.0/scalable/mimetypes/application-vnd.sun.xml.writer.template.svg	pass	1694720	930326	764394	0
svgs/oxygen-icons-5.113.0/scalable/mimetypes/application-vnd.wordperfect.svg	pass	1560458	912161	648297	0
svgs/oxygen-icons-5.113.0/scalable/mimetypes/application-x-7z-compressed.svg	pass	259194	100540	158654	0
svgs/oxygen-icons-5.113.0/scalable/mimetypes/application-x-abiword.svg	pass	1569188	908022	661166	0
svgs/oxygen-icons-5.113.0/scalable/mimetypes/application-x-ace.svg	pass	259194	100540	158654	0
svgs/oxygen-icons-5.113.0/scalable/mimetypes/application-x-applix-spreadsheet.svg	pass	86189	22712	63477	0
svgs/oxygen-icons-5.113.0/scalable/mimetypes/application-x-applix-word.svg	pass	1530847	881731	649116	0
svgs/oxygen-icons-5.113.0/scalable/mimetypes/application-x-ar.svg	pass	109368	35805	73563	0
svgs/oxygen-icons-5.113.0/scalable/mimetypes/application-x-arc.svg	pass	259194	100540	158654	0
svgs/oxygen-icons-5.113.0/scalable/mimetypes/application-x-archive.svg	pass	109357	35805	73552	0
svgs/oxygen-icons-5.113.0/scalable/mimetypes/application-x-arj.svg	pass	259194	100540	158654	0
svgs/oxygen-icons-5.113.0/scalable/mimetypes/application-x-awk.svg	pass	16525	8701	7824	0
svgs/oxygen-icons-5.113.0/scalable/mimetypes/application-x-bittorrent.svg	pass	257770	125372	132398	0
svgs/oxygen-icons-5.113.0/scalable/mimetypes/application-x-blender.svg	pass	105766	31013	74753	0
svgs/oxygen-icons-5.113.0/scalable/mimetypes/application-x-bzdvi.svg	pass	263990	98960	165030	0
svgs/oxygen-icons-5.113.0/scalable/mimetypes/application-x-bzip-compressed-tar.svg	pass	259194	100540	158654	0
svgs/oxygen-icons-5.113.0/scalable/mimetypes/application-x-bzip.svg	pass	242757	90315	152442	0
svgs/oxygen-icons-5.113.0/scalable/mimetypes/application-x-cd-image.svg	pass	166573	58588	107985	0
svgs/oxygen-icons-5.113.0/scalable/mimetypes/application-x-cda.svg	pass	172805	68161	104644	0
svgs/oxygen-icons-5.113.0/scalable/mimetypes/application-x-chm.svg	pass	75648	12216	63432	0
svgs/oxygen-icons-5.113.0/scalable/mimetypes/application-x-compress.svg	pass	242757	90315	152442	0
svgs/oxygen-icons-5.113.0/scalable/mimetypes/application-x-compressed-tar.svg	pass	110450	36776	73674	0
svgs/oxygen-icons-5.113.0/scalable/mimetypes/application-x-cpio.svg	pass	109368	35805	73563	0
svgs/oxygen-icons-5.113.0/scalable/mimetypes/application-x-cue.svg	pass	332179	179484	152695	0
svgs/oxygen-icons-5.113.0/scalable/mimetypes/application-x-deb.svg	pass	110252	36776	73476	0
svgs/oxygen-icons-5.113.0/scalable/mimetypes/application-x-designer.svg	pass	179733	56378	123355	0
svgs/oxygen-icons-5.113.0/scalable/mimetypes/application-x-desktop.svg	pass	87360	40450	46910	0
svgs/oxygen-icons-5.113.0/scalable/mimetypes/application-x-egon.svg	pass	246742	155234	91508	0
svgs/oxygen-icons-5.113.0/scalable/mimetypes/application-x-executable-script.svg	pass	951916	44062	907854	0
svgs/oxygen-icons-5.113.0/scalable/mimetypes/application-x-executable.svg	pass	87360	40450	46910	0
svgs/oxygen-icons-5.113.0/scalable/mimetypes/application-x-font-afm.svg	pass	124645	28858	95787	0
svgs/oxygen-icons-5.113.0/scalable/mimetypes/application-x-font-bdf.svg	pass	97112	31825	65287	0
svgs/oxygen-icons-5.113.0/scalable/mimetypes/application-x-font-otf.svg	pass	105405	34309	71096	0
svgs/oxygen-icons-5.113.0/scalable/mimetypes/application-x-font-pcf.svg	pass	97112	31825	65287	0
svgs/oxygen-icons-5.113.0/scalable/mimetypes/application-x-font-snf.svg	pass	97112	31825	65287	0
svgs/oxygen-icons-5.113.0/scalable/mimetypes/application-x-font-ttf.svg	pass	101745	27237	74508	0
svgs/oxygen-icons-5.113.0/scalable/mimetypes/application-x-font-type1.svg	pass	124645	28858	95787	0
svgs/oxygen-icons-5.113.0/scalable/mimetypes/application-x-gnumeric.svg	pass	86189	22712	63477	0
svgs/oxygen-icons-5.113.0/scalable/mimetypes/application-x-gzdvi.svg	pass	263990	98960	165030	0
svgs/oxygen-icons-5.113.0/scalable/mimetypes/application-x-gzip.svg	pass	242757	90315	152442	0
svgs/oxygen-icons-5.113.0/scalable/mimetypes/application-x-gzpostscript.svg	pass	467865	109848	358017	0
svgs/oxygen-icons-5.113.0/scalable/mimetypes/application-x-it87.svg	pass	193841	53956	139885	0
svgs/oxygen-icons-5.113.0/scalable/mimetypes/application-x-java-applet.svg	pass	1630899	803313	827586	0
svgs/oxygen-icons-5.113.0/scalable/mimetypes/application-x-java-archive.svg	pass	110450	36776	73674	0
svgs/oxygen-icons-5.113.0/scalable/mimetypes/application-x-java.svg	pass	130184	46422	83762	0
svgs/oxygen-icons-5.113.0/scalable/mimetypes/application-x-javascript.svg	pass	99690	22887	76803	0
svgs/oxygen-icons-5.113.0/scalable/mimetypes/application-x-k3b.svg	mismatch	319839	181747	138092	111
svgs/oxygen-icons-5.113.0/scalable/mimetypes/application-x-kcsrc.svg	pass	153904	51245	102659	0
svgs/oxygen-icons-5.113.0/scalable/mimetypes/application-x-kexi-connectiondata.svg	pass	769022	187869	581153	0
svgs/oxygen-icons-5.113.0/scalable/mimetypes/application-x-kexiproject-shortcut.svg	pass	769360	188187	581173	0
svgs/oxygen-icons-5.113.0/scalable/mimetypes/application-x-kexiproject-sqlite.svg	pass	714235	172409	541826	0
svgs/oxygen-icons-5.113.0/scalable/mimetypes/application-x-kexiproject-sqlite2.svg	pass	714235	172409	541826	0
svgs/oxygen-icons-5.113.0/scalable/mimetypes/application-x-kexiproject-sqlite3.svg	pass	714235	172409	541826	0
svgs/oxygen-icons-5.113.0/scalable/mimetypes/application-x-kformula.svg	pass	336433	162913	173520	0
svgs/oxygen-icons-5.113.0/scalable/mimetypes/application-x-kgetlist.svg	pass	103849	32183	71666	0
svgs/oxygen-icons-5.113.0/scalable/mimetypes/application-x-kontour.svg	pass	143538	24648	118890	0
svgs/oxygen-icons-5.113.0/scalable/mimetypes/application-x-kplato.svg	pass	267269	131535	135734	0
svgs/oxygen-icons-5.113.0/scalable/mimetypes/application-x-krita.svg	pass	259370	95119	164251	0
svgs/oxygen-icons-5.113.0/scalable/mimetypes/application-x-kvtml.svg	mismatch	80705	9180	71525	77
svgs/oxygen-icons-5.113.0/scalable/mimetypes/application-x-kword.svg	pass	1569188	908022	661166	0
svgs/oxygen-icons-5.113.0/scalable/mimetypes/application-x-lha.svg	pass	259194	100540	158654	0
svgs/oxygen-icons-5.113.0/scalable/mimetypes/application-x-lyx.svg	pass	1515599	884139	631460	0
svgs/oxygen-icons-5.113.0/scalable/mimetypes/application-x-lzma-compressed-tar.svg	pass	109368	35805	73563	0
svgs/oxygen-icons-5.113.0/scalable/mimetypes/application-x-lzop.svg	pass	242757	90315	152442	0
svgs/oxygen-icons-5.113.0/scalable/mimetypes/application-x-m4.svg	pass	268333	119790	148543	0
svgs/oxygen-icons-5.113.0/scalable/mimetypes/application-x-marble.svg	pass	573840	225691	348149	0
svgs/oxygen-icons-5.113.0/scalable/mimetypes/application-x-mimearchive.svg	pass	909212	427382	481830	3
svgs/oxygen-icons-5.113.0/scalable/mimetypes/application-x-mplayer2.svg	pass	112565	33231	79334	0
svgs/oxygen-icons-5.113.0/scalable/mimetypes/application-x-ms-dos-executable.svg	pass	255270	43778	211492	0
svgs/oxygen-icons-5.113.0/scalable/mimetypes/application-x-mswinurl.svg	pass	2233979	1122118	1111861	0
svgs/oxygen-icons-5.113.0/scalable/mimetypes/application-x-mswrite.svg	pass	1558365	879537	678828	0
svgs/oxygen-icons-5.113.0/scalable/mimetypes/application-x-nzb.svg	pass	69876	13660	56216	0
svgs/oxygen-icons-5.113.0/scalable/mimetypes/application-x-object.svg	pass	268257	152175	116082	0
svgs/oxygen-icons-5.113.0/scalable/mimetypes/application-x-pak.svg	pass	242757	90315	152442	0
svgs/oxygen-icons-5.113.0/scalable/mimetypes/application-x-pem-key.svg	pass	405316	80993	324323	1
svgs/oxygen-icons-5.113.0/scalable/mimetypes/application-x-perl.svg	pass	903471	511892	391579	0
svgs/oxygen-icons-5.113.0/scalable/mimetypes/application-x-php.svg	pass	110952	35451	75501	0
svgs/oxygen-icons-5.113.0/scalable/mimetypes/application-x-plasma.svg	pass	174234	71529	102705	0
svgs/oxygen-icons-5.113.0/scalable/mimetypes/application-x-python-bytecode.svg	pass	268257	152175	116082	0
svgs/oxygen-icons-5.113.0/scalable/mimetypes/application-x-qet-element.svg	pass	200781	23965	176816	0
svgs/oxygen-icons-5.113.0/scalable/mimetypes/application-x-qet-project.svg	pass	260873	58965	201908	0
svgs/oxygen-icons-5.113.0/scalable/mimetypes/application-x-quattropro.svg	pass	86189	22712	63477	0
svgs/oxygen-icons-5.113.0/scalable/mimetypes/application-x-rar.svg	pass	259194	100540	158654	0
svgs/oxygen-icons-5.113.0/scalable/mimetypes/application-x-rpm.svg	pass	110267	36776	73491	0
svgs/oxygen-icons-5.113.0/scalable/mimetypes/application-x-ruby.svg	pass	249997	70946	179051	0
svgs/oxygen-icons-5.113.0/scalable/mimetypes/application-x-sharedlib.svg	pass	268257	152175	116082	0
svgs/oxygen-icons-5.113.0/scalable/mimetypes/application-x-shellscript.svg	pass	135532	13658	121874	0
svgs/oxygen-icons-5.113.0/scalable/mimetypes/application-x-shockwave-flash.svg	pass	110426	33257	77169	0
svgs/oxygen-icons-5.113.0/scalable/mimetypes/application-x-siag.svg	pass	86189	22712	63477	0
svgs/oxygen-icons-5.113.0/scalable/mimetypes/application-x-skg.svg	pass	153258	23576	129682	0
svgs/oxygen-icons-5.113.0/scalable/mimetypes/application-x-skgc.svg	pass	394525	160069	234456	0
svgs/oxygen-icons-5.113.0/scalable/mimetypes/application-x-smb-server.svg	pass	172044	64708	107336	0
svgs/oxygen-icons-5.113.0/scalable/mimetypes/application-x-smb-workgroup.svg	pass	867910	347680	520230	0
svgs/oxygen-icons-5.113.0/scalable/mimetypes/application-x-sqlite2.svg	pass	714235	172409	541826	0
svgs/oxygen-icons-5.113.0/scalable/mimetypes/application-x-sqlite3.svg	pass	714235	172409	541826	0
svgs/oxygen-icons-5.113.0/scalable/mimetypes/application-x-srt.svg	pass	582232	275406	306826	0
svgs/oxygen-icons-5.113.0/scalable/mimetypes/application-x-srtrip.svg	pass	582232	275406	306826	0
svgs/oxygen-icons-5.113.0/scalable/mimetypes/application-x-subrip.svg	pass	591671	275412	316259	0
svgs/oxygen-icons-5.113.0/scalable/mimetypes/application-x-tar.svg	pass	109368	35805	73563	0
svgs/oxygen-icons-5.113.0/scalable/mimetypes/application-x-tarz.svg	pass	259194	100540	158654	0
svgs/oxygen-icons-5.113.0/scalable/mimetypes/application-x-tgif.svg	pass	143538	24648	118890	0
svgs/oxygen-icons-5.113.0/scalable/mimetypes/application-x-trash.svg	pass	83677	15990	67687	0
svgs/oxygen-icons-5.113.0/scalable/mimetypes/application-x-troff-man.svg	pass	74965	14117	60848	0
svgs/oxygen-icons-5.113.0/scalable/mimetypes/application-x-tzo.svg	pass	259194	100540	158654	0
svgs/oxygen-icons-5.113.0/scalable/mimetypes/application-x-wmf.svg	pass	143538	24648	118890	0
svgs/oxygen-icons-5.113.0/scalable/mimetypes/application-x-zerosize.svg	pass	46842	6658	40184	0
svgs/oxygen-icons-5.113.0/scalable/mimetypes/application-x-zoo.svg	pass	259194	100540	158654	0
svgs/oxygen-icons-5.113.0/scalable/mimetypes/application-xhtml+xml.svg	pass	2283031	1125858	1157173	0
svgs/oxygen-icons-5.113.0/scalable/mimetypes/application-xml.svg	pass	114455	23923	90532	0
svgs/oxygen-icons-5.113.0/scalable/mimetypes/application-xsd.svg	pass	1741874	855113	886761	1
svgs/oxygen-icons-5.113.0/scalable/mimetypes/application-xslt+xml.svg	pass	2234484	1121249	1113235	0
svgs/oxygen-icons-5.113.0/scalable/mimetypes/application-zip.svg	pass	259194	100540	158654	0
svgs/oxygen-icons-5.113.0/scalable/mimetypes/audio-ac3.svg	pass	284164	72887	211277	0
svgs/oxygen-icons-5.113.0/scalable/mimetypes/audio-midi.svg	pass	420515	200408	220107	0
svgs/oxygen-icons-5.113.0/scalable/mimetypes/audio-prs.sid.svg	pass	420515	200408	220107	0
svgs/oxygen-icons-5.113.0/scalable/mimetypes/audio-vn.rn-realmedia.svg	pass	112565	33231	79334	0
svgs/oxygen-icons-5.113.0/scalable/mimetypes/audio-vn.rn-realvideo.svg	pass	112565	33231	79334	0
svgs/oxygen-icons-5.113.0/scalable/mimetypes/audio-vnd.rn-realvideo.svg	pass	112565	33231	79334	0
svgs/oxygen-icons-5.113.0/scalable/mimetypes/audio-x-adpcm.svg	pass	134764	42927	91837	0
svgs/oxygen-icons-5.113.0/scalable/mimetypes/audio-x-aiff.svg	pass	134764	42927	91837	0
svgs/oxygen-icons-5.113.0/scalable/mimetypes/audio-x-flac+ogg.svg	pass	285237	72881	212356	0
svgs/oxygen-icons-5.113.0/scalable/mimetypes/audio-x-flac.svg	pass	285237	72881	212356	0
svgs/oxygen-icons-5.113.0/scalable/mimetypes/audio-x-generic.svg	pass	285237	72881	212356	0
svgs/oxygen-icons-5.113.0/scalable/mimetypes/audio-x-monkey.svg	pass	285237	72881	212356	0
svgs/oxygen-icons-5.113.0/scalable/mimetypes/audio-x-speex+ogg.svg	pass	211459	74108	137351	0
svgs/oxygen-icons-5.113.0/scalable/mimetypes/audio-x-wav.svg	pass	134764	42927	91837	0
svgs/oxygen-icons-5.113.0/scalable/mimetypes/encrypted.svg	pass	412491	83037	329454	1
svgs/oxygen-icons-5.113.0/scalable/mimetypes/hidef/application-epub+zip.svg	pass	2407260	1965710	441550	0
svgs/oxygen-icons-5.113.0/scalable/mimetypes/hidef/application-illustrator.svg	pass	68040	12224	55816	0
svgs/oxygen-icons-5.113.0/scalable/mimetypes/hidef/application-javascript.svg	pass	94397	22487	71910	0
svgs/oxygen-icons-5.113.0/scalable/mimetypes/hidef/application-msword-template.svg	pass	1618644	922200	696444	0
svgs/oxygen-icons-5.113.0/scalable/mimetypes/hidef/application-msword.svg	pass	1563068	909776	653292	0
svgs/oxygen-icons-5.113.0/scalable/mimetypes/hidef/application-octet-stream.svg	pass	847089	497752	349337	0
svgs/oxygen-icons-5.113.0/scalable/mimetypes/hidef/application-pdf.svg	pass	65840	9326	56514	0
svgs/oxygen-icons-5.113.0/scalable/mimetypes/hidef/application-pgp-encrypted.svg	pass	157471	21388	136083	0
svgs/oxygen-icons-5.113.0/scalable/mimetypes/hidef/application-pgp-keys.svg	pass	399967	79907	320060	0
svgs/oxygen-icons-5.113.0/scalable/mimetypes/hidef/application-pkcs7-mime.svg	pass	401919	80913	321006	0
svgs/oxygen-icons-5.113.0/scalable/mimetypes/hidef/application-postscript.svg	pass	114012	40249	73763	0
svgs/oxygen-icons-5.113.0/scalable/mimetypes/hidef/application-relaxng.svg	pass	1675642	603703	1071939	0
svgs/oxygen-icons-5.113.0/scalable/mimetypes/hidef/application-rtf.svg	pass	247329	135530	111799	0
svgs/oxygen-icons-5.113.0/scalable/mimetypes/hidef/application-sxw.svg	pass	305833	169083	136750	0
svgs/oxygen-icons-5.113.0/scalable/mimetypes/hidef/application-vnd-google-earth-kml.svg	pass	52837	8861	43976	3
svgs/oxygen-icons-5.113.0/scalable/mimetypes/hidef/application-vnd.iccprofile.svg	pass	185641	53467	132174	0
svgs/oxygen-icons-5.113.0/scalable/mimetypes/hidef/application-vnd.ms-access.svg	pass	712327	173081	539246	0
svgs/oxygen-icons-5.113.0/scalable/mimetypes/hidef/application-vnd.ms-excel.svg	pass	97306	25019	72287	0
svgs/oxygen-icons-5.113.0/scalable/mimetypes/hidef/application-vnd.ms-powerpoint.svg	pass	205366	37560	167806	0
svgs/oxygen-icons-5.113.0/scalable/mimetypes/hidef/application-vnd.oasis.opendocument.chart.svg	pass	250827	65570	185257	0
svgs/oxygen-icons-5.113.0/scalable/mimetypes/hidef/application-vnd.oasis.opendocument.database.svg	pass	710713	171329	539384	0
svgs/oxygen-icons-5.113.0/scalable/mimetypes/hidef/application-vnd.oasis.opendocument.formula-template.svg	pass	407323	196444	210879	0
svgs/oxygen-icons-5.113.0/scalable/mimetypes/hidef/application-vnd.oasis.opendocument.formula.svg	pass	329913	162419	167494	0
svgs/oxygen-icons-5.113.0/scalable/mimetypes/hidef/application-vnd.oasis.opendocument.graphics.svg	pass	178407	34707	143700	0
svgs/oxygen-icons-5.113.0/scalable/mimetypes/hidef/application-vnd.oasis.opendocument.image.svg	pass	310668	118438	192230	0
svgs/oxygen-icons-5.113.0/scalable/mimetypes/hidef/application-vnd.oasis.opendocument.presentation-template.svg	pass	171724	40259	131465	0
svgs/oxygen-icons-5.113.0/scalable/mimetypes/hidef/application-vnd.oasis.opendocument.presentation.svg	pass	202445	35485	166960	0
svgs/oxygen-icons-5.113.0/scalable/mimetypes/hidef/application-vnd.oasis.opendocument.spreadsheet-template.svg	pass	151219	36680	114539	0
svgs/oxygen-icons-5.113.0/scalable/mimetypes/hidef/application-vnd.oasis.opendocument.spreadsheet.svg	pass	94456	23577	70879	0
svgs/oxygen-icons-5.113.0/scalable/mimetypes/hidef/application-vnd.oasis.opendocument.text.svg	pass	1520123	897042	623081	0
svgs/oxygen-icons-5.113.0/scalable/mimetypes/hidef/application-vnd.openxmlformats-officedocument.wordprocessingml.document.svg	pass	1520123	897042	623081	0
svgs/oxygen-icons-5.113.0/scalable/mimetypes/hidef/application-vnd.rn-realmedia.svg	pass	106687	32899	73788	0
svgs/oxygen-icons-5.113.0/scalable/mimetypes/hidef/application-vnd.scribus.svg	pass	564448	139624	424824	0
svgs/oxygen-icons-5.113.0/scalable/mimetypes/hidef/application-vnd.stardivision.calc.svg	pass	94456	23577	70879	0
svgs/oxygen-icons-5.113.0/scalable/mimetypes/hidef/application-vnd.stardivision.draw.svg	pass	310668	118438	192230	0
svgs/oxygen-icons-5.113.0/scalable/mimetypes/hidef/application-vnd.stardivision.mail.svg	pass	900786	426926	473860	4
svgs/oxygen-icons-5.113.0/scalable/mimetypes/hidef/application-vnd.stardivision.math.svg	pass	329913	162419	167494	0
svgs/oxygen-icons-5.113.0/scalable/mimetypes/hidef/application-vnd.sun.xml.calc.svg	pass	94456	23577	70879	0
svgs/oxygen-icons-5.113.0/scalable/mimetypes/hidef/application-vnd.sun.xml.calc.template.svg	pass	151219	36680	114539	0
svgs/oxygen-icons-5.113.0/scalable/mimetypes/hidef/application-vnd.sun.xml.draw.svg	pass	310668	118438	192230	0
svgs/oxygen-icons-5.113.0/scalable/mimetypes/hidef/application-vnd.sun.xml.draw.template.svg	pass	371928	127932	243996	0
svgs/oxygen-icons-5.113.0/scalable/mimetypes/hidef/application-vnd.sun.xml.math.svg	pass	329913	162419	167494	0
svgs/oxygen-icons-5.113.0/scalable/mimetypes/hidef/application-vnd.wordperfect.svg	pass	1562016	909072	652944	0
svgs/oxygen-icons-5.113.0/scalable/mimetypes/hidef/application-x-7z-compressed.svg	pass	254671	101978	152693	0
svgs/oxygen-icons-5.113.0/scalable/mimetypes/hidef/application-x-abiword.svg	pass	1520123	897042	623081	0
svgs/oxygen-icons-5.113.0/scalable/mimetypes/hidef/application-x-ace.svg	pass	254671	101978	152693	0
svgs/oxygen-icons-5.113.0/scalable/mimetypes/hidef/application-x-applix-spreadsheet.svg	pass	94456	23577	70879	0
svgs/oxygen-icons-5.113.0/scalable/mimetypes/hidef/application-x-applix-word.svg	pass	1492671	882620	610051	0
svgs/oxygen-icons-5.113.0/scalable/mimetypes/hidef/application-x-ar.svg	pass	103784	35627	68157	0
svgs/oxygen-icons-5.113.0/scalable/mimetypes/hidef/application-x-arc.svg	pass	254671	101978	152693	0
svgs/oxygen-icons-5.113.0/scalable/mimetypes/hidef/application-x-archive.svg	pass	103797	35627	68170	0
svgs/oxygen-icons-5.113.0/scalable/mimetypes/hidef/application-x-arj.svg	pass	254671	101978	152693	0
svgs/oxygen-icons-5.113.0/scalable/mimetypes/hidef/application-x-bittorrent.svg	pass	173245	77437	95808	0
svgs/oxygen-icons-5.113.0/scalable/mimetypes/hidef/application-x-blender.svg	pass	101734	30676	71058	0
svgs/oxygen-icons-5.113.0/scalable/mimetypes/hidef/application-x-bzdvi.svg	pass	251246	99510	151736	0
svgs/oxygen-icons-5.113.0/scalable/mimetypes/hidef/application-x-bzip-compressed-tar.svg	pass	254671	101978	152693	0
svgs/oxygen-icons-5.113.0/scalable/mimetypes/hidef/application-x-bzip.svg	pass	236371	89890	146481	0
svgs/oxygen-icons-5.113.0/scalable/mimetypes/hidef/application-x-cd-image.svg	pass	158246	57820	100426	0
svgs/oxygen-icons-5.113.0/scalable/mimetypes/hidef/application-x-cda.svg	pass	165041	67612	97429	0
svgs/oxygen-icons-5.113.0/scalable/mimetypes/hidef/application-x-chm.svg	pass	69815	11908	57907	0
svgs/oxygen-icons-5.113.0/scalable/mimetypes/hidef/application-x-compress.svg	pass	236371	89890	146481	0
svgs/oxygen-icons-5.113.0/scalable/mimetypes/hidef/application-x-compressed-tar.svg	pass	105303	36560	68743	0
svgs/oxygen-icons-5.113.0/scalable/mimetypes/hidef/application-x-cue.svg	pass	330828	178808	152020	0
svgs/oxygen-icons-5.113.0/scalable/mimetypes/hidef/application-x-deb.svg	pass	105281	36560	68721	0
svgs/oxygen-icons-5.113.0/scalable/mimetypes/hidef/application-x-designer.svg	pass	174067	55467	118600	0
svgs/oxygen-icons-5.113.0/scalable/mimetypes/hidef/application-x-desktop.svg	pass	87990	40416	47574	0
svgs/oxygen-icons-5.113.0/scalable/mimetypes/hidef/application-x-dgn.svg	pass	317778	52722	265056	0
svgs/oxygen-icons-5.113.0/scalable/mimetypes/hidef/application-x-egon.svg	pass	240717	154219	86498	0
svgs/oxygen-icons-5.113.0/scalable/mimetypes/hidef/application-x-executable-script.svg	pass	96443	43981	52462	0
svgs/oxygen-icons-5.113.0/scalable/mimetypes/hidef/application-x-executable.svg	pass	87990	40416	47574	0
svgs/oxygen-icons-5.113.0/scalable/mimetypes/hidef/application-x-font-afm.svg	pass	115803	28529	87274	0
svgs/oxygen-icons-5.113.0/scalable/mimetypes/hidef/application-x-font-bdf.svg	pass	83197	31528	51669	0
svgs/oxygen-icons-5.113.0/scalable/mimetypes/hidef/application-x-font-otf.svg	pass	101197	34071	67126	0
svgs/oxygen-icons-5.113.0/scalable/mimetypes/hidef/application-x-font-pcf.svg	pass	83214	31528	51686	0
svgs/oxygen-icons-5.113.0/scalable/mimetypes/hidef/application-x-font-snf.svg	pass	83215	31528	51687	0
svgs/oxygen-icons-5.113.0/scalable/mimetypes/hidef/application-x-font-ttf.svg	pass	95299	30672	64627	0
svgs/oxygen-icons-5.113.0/scalable/mimetypes/hidef/application-x-font-type1.svg	pass	115802	28529	87273	0
svgs/oxygen-icons-5.113.0/scalable/mimetypes/hidef/application-x-gnumeric.svg	pass	94456	23577	70879	0
svgs/oxygen-icons-5.113.0/scalable/mimetypes/hidef/application-x-gzdvi.svg	pass	251246	99510	151736	0
svgs/oxygen-icons-5.113.0/scalable/mimetypes/hidef/application-x-gzip.svg	pass	236371	89890	146481	0
svgs/oxygen-icons-5.113.0/scalable/mimetypes/hidef/application-x-gzpostscript.svg	pass	351770	108809	242961	0
svgs/oxygen-icons-5.113.0/scalable/mimetypes/hidef/application-x-it87.svg	pass	185641	53467	132174	0
svgs/oxygen-icons-5.113.0/scalable/mimetypes/hidef/application-x-java-applet.svg	pass	1629387	803273	826114	0
svgs/oxygen-icons-5.113.0/scalable/mimetypes/hidef/application-x-java-archive.svg	pass	105304	36560	68744	0
svgs/oxygen-icons-5.113.0/scalable/mimetypes/hidef/application-x-java.svg	pass	124682	45703	78979	0
svgs/oxygen-icons-5.113.0/scalable/mimetypes/hidef/application-x-javascript.svg	pass	94428	22487	71941	0
svgs/oxygen-icons-5.113.0/scalable/mimetypes/hidef/application-x-k3b.svg	mismatch	314960	181452	133508	38
svgs/oxygen-icons-5.113.0/scalable/mimetypes/hidef/application-x-kcsrc.svg	pass	149029	50936	98093	0
svgs/oxygen-icons-5.113.0/scalable/mimetypes/hidef/application-x-kformula.svg	pass	329913	162419	167494	0
svgs/oxygen-icons-5.113.0/scalable/mimetypes/hidef/application-x-kgetlist.svg	pass	99369	31795	67574	0
svgs/oxygen-icons-5.113.0/scalable/mimetypes/hidef/application-x-kontour.svg	pass	136289	22831	113458	0
svgs/oxygen-icons-5.113.0/scalable/mimetypes/hidef/application-x-kplato.svg	pass	113180	28237	84943	0
svgs/oxygen-icons-5.113.0/scalable/mimetypes/hidef/application-x-krita.svg	pass	253258	94802	158456	0
svgs/oxygen-icons-5.113.0/scalable/mimetypes/hidef/application-x-kword.svg	pass	1520123	897042	623081	0
svgs/oxygen-icons-5.113.0/scalable/mimetypes/hidef/application-x-lha.svg	pass	254671	101978	152693	0
svgs/oxygen-icons-5.113.0/scalable/mimetypes/hidef/application-x-lyx.svg	pass	1507067	888012	619055	0
svgs/oxygen-icons-5.113.0/scalable/mimetypes/hidef/application-x-lzop.svg	pass	236371	89890	146481	0
svgs/oxygen-icons-5.113.0/scalable/mimetypes/hidef/application-x-m4.svg	pass	262366	119462	142904	0
svgs/oxygen-icons-5.113.0/scalable/mimetypes/hidef/application-x-marble.svg	pass	567465	225403	342062	0
svgs/oxygen-icons-5.113.0/scalable/mimetypes/hidef/application-x-mimearchive.svg	pass	900786	426926	473860	4
svgs/oxygen-icons-5.113.0/scalable/mimetypes/hidef/application-x-mplayer2.svg	pass	106687	32899	73788	0
svgs/oxygen-icons-5.113.0/scalable/mimetypes/hidef/application-x-ms-dos-executable.svg	pass	102964	44080	58884	0
svgs/oxygen-icons-5.113.0/scalable/mimetypes/hidef/application-x-mswinurl.svg	pass	3409766	1768055	1641711	0
svgs/oxygen-icons-5.113.0/scalable/mimetypes/hidef/application-x-mswrite.svg	pass	1547184	880919	666265	0
svgs/oxygen-icons-5.113.0/scalable/mimetypes/hidef/application-x-nzb.svg	pass	64027	13337	50690	0
svgs/oxygen-icons-5.113.0/scalable/mimetypes/hidef/application-x-object.svg	pass	847089	497752	349337	0
svgs/oxygen-icons-5.113.0/scalable/mimetypes/hidef/application-x-pak.svg	pass	236371	89890	146481	0
svgs/oxygen-icons-5.113.0/scalable/mimetypes/hidef/application-x-pem-key.svg	pass	400587	79909	320678	0
svgs/oxygen-icons-5.113.0/scalable/mimetypes/hidef/application-x-perl.svg	pass	898457	511450	387007	0
svgs/oxygen-icons-5.113.0/scalable/mimetypes/hidef/application-x-php.svg	pass	105999	34575	71424	0
svgs/oxygen-icons-5.113.0/scalable/mimetypes/hidef/application-x-plasma.svg	pass	167372	71095	96277	0
svgs/oxygen-icons-5.113.0/scalable/mimetypes/hidef/application-x-python-bytecode.svg	pass	847089	497752	349337	0
svgs/oxygen-icons-5.113.0/scalable/mimetypes/hidef/application-x-qet-element.svg	pass	194564	23178	171386	0
svgs/oxygen-icons-5.113.0/scalable/mimetypes/hidef/application-x-qet-project.svg	pass	261576	58306	203270	0
svgs/oxygen-icons-5.113.0/scalable/mimetypes/hidef/application-x-quattropro.svg	pass	94456	23577	70879	0
svgs/oxygen-icons-5.113.0/scalable/mimetypes/hidef/application-x-rar.svg	pass	254671	101978	152693	0
svgs/oxygen-icons-5.113.0/scalable/mimetypes/hidef/application-x-rpm.svg	pass	105474	36560	68914	0
svgs/oxygen-icons-5.113.0/scalable/mimetypes/hidef/application-x-ruby.svg	pass	243299	70023	173276	0
svgs/oxygen-icons-5.113.0/scalable/mimetypes/hidef/application-x-sharedlib.svg	pass	847089	497752	349337	0
svgs/oxygen-icons-5.113.0/scalable/mimetypes/hidef/application-x-shellscript.svg	pass	131040	13281	117759	0
svgs/oxygen-icons-5.113.0/scalable/mimetypes/hidef/application-x-shockwave-flash.svg	pass	107895	33815	74080	0
svgs/oxygen-icons-5.113.0/scalable/mimetypes/hidef/application-x-siag.svg	pass	94456	23577	70879	0
svgs/oxygen-icons-5.113.0/scalable/mimetypes/hidef/application-x-srt.svg	pass	224688	130060	94628	0
svgs/oxygen-icons-5.113.0/scalable/mimetypes/hidef/application-x-srtrip.svg	pass	224688	130060	94628	0
svgs/oxygen-icons-5.113.0/scalable/mimetypes/hidef/application-x-subrip.svg	pass	226806	131219	95587	0
svgs/oxygen-icons-5.113.0/scalable/mimetypes/hidef/application-x-tar.svg	pass	103784	35627	68157	0
svgs/oxygen-icons-5.113.0/scalable/mimetypes/hidef/application-x-tarz.svg	pass	254671	101978	152693	0
svgs/oxygen-icons-5.113.0/scalable/mimetypes/hidef/application-x-tgif.svg	pass	136289	22831	113458	0
svgs/oxygen-icons-5.113.0/scalable/mimetypes/hidef/application-x-trash.svg	pass	79387	15513	63874	0
svgs/oxygen-icons-5.113.0/scalable/mimetypes/hidef/application-x-troff-man.svg	pass	77089	24977	52112	0
svgs/oxygen-icons-5.113.0/scalable/mimetypes/hidef/application-x-tzo.svg	pass	254671	101978	152693	0
svgs/oxygen-icons-5.113.0/scalable/mimetypes/hidef/application-x-wmf.svg	pass	136289	22831	113458	0
svgs/oxygen-icons-5.113.0/scalable/mimetypes/hidef/application-x-zerosize.svg	pass	46537	6556	39981	0
svgs/oxygen-icons-5.113.0/scalable/mimetypes/hidef/application-x-zoo.svg	pass	254671	101978	152693	0
svgs/oxygen-icons-5.113.0/scalable/mimetypes/hidef/application-xhtml+xml.svg	pass	2278467	1125546	1152921	0
svgs/oxygen-icons-5.113.0/scalable/mimetypes/hidef/application-xml.svg	pass	114960	28694	86266	0
svgs/oxygen-icons-5.113.0/scalable/mimetypes/hidef/application-xsd.svg	pass	1734807	853452	881355	2
svgs/oxygen-icons-5.113.0/scalable/mimetypes/hidef/application-xslt+xml.svg	pass	2228094	1120742	1107352	0
svgs/oxygen-icons-5.113.0/scalable/mimetypes/hidef/application-zip.svg	pass	254671	101978	152693	0
svgs/oxygen-icons-5.113.0/scalable/mimetypes/hidef/audio-ac3.svg	pass	648625	240503	408122	0
svgs/oxygen-icons-5.113.0/scalable/mimetypes/hidef/audio-midi.svg	pass	417833	200032	217801	0
svgs/oxygen-icons-5.113.0/scalable/mimetypes/hidef/audio-prs.sid.svg	pass	417837	200032	217805	0
svgs/oxygen-icons-5.113.0/scalable/mimetypes/hidef/audio-vn.rn-realmedia.svg	pass	106687	32899	73788	0
svgs/oxygen-icons-5.113.0/scalable/mimetypes/hidef/audio-vn.rn-realvideo.svg	pass	106687	32899	73788	0
svgs/oxygen-icons-5.113.0/scalable/mimetypes/hidef/audio-vnd.rn-realvideo.svg	pass	106687	32899	73788	0
svgs/oxygen-icons-5.113.0/scalable/mimetypes/hidef/audio-x-adpcm.svg	pass	129840	42556	87284	0
svgs/oxygen-icons-5.113.0/scalable/mimetypes/hidef/audio-x-aiff.svg	pass	129840	42556	87284	0
svgs/oxygen-icons-5.113.0/scalable/mimetypes/hidef/audio-x-flac+ogg.svg	pass	651636	243516	408120	0
svgs/oxygen-icons-5.113.0/scalable/mimetypes/hidef/audio-x-flac.svg	pass	651636	243516	408120	0
svgs/oxygen-icons-5.113.0/scalable/mimetypes/hidef/audio-x-generic.svg	pass	651636	243516	408120	0
svgs/oxygen-icons-5.113.0/scalable/mimetypes/hidef/audio-x-monkey.svg	pass	651636	243516	408120	0
svgs/oxygen-icons-5.113.0/scalable/mimetypes/hidef/audio-x-speex+ogg.svg	pass	205592	73143	132449	0
svgs/oxygen-icons-5.113.0/scalable/mimetypes/hidef/audio-x-wav.svg	pass	129840	42556	87284	0
svgs/oxygen-icons-5.113.0/scalable/mimetypes/hidef/encrypted.svg	pass	408520	81122	327398	0
svgs/oxygen-icons-5.113.0/scalable/mimetypes/hidef/image-svg+xml-compressed.svg	pass	367310	108642	258668	0
svgs/oxygen-icons-5.113.0/scalable/mimetypes/hidef/image-svg+xml.svg	pass	136289	22831	113458	0
svgs/oxygen-icons-5.113.0/scalable/mimetypes/hidef/image-vnd.dwg.svg	pass	321481	54547	266934	0
svgs/oxygen-icons-5.113.0/scalable/mimetypes/hidef/image-x-adobe-dng.svg	pass	689971	556810	133161	0
svgs/oxygen-icons-5.113.0/scalable/mimetypes/hidef/image-x-eps.svg	pass	135939	22660	113279	0
svgs/oxygen-icons-5.113.0/scalable/mimetypes/hidef/image-x-generic.svg	pass	240310	153936	86374	0
svgs/oxygen-icons-5.113.0/scalable/mimetypes/hidef/image-x-vnd.trolltech.qpicture.svg	pass	136525	22988	113537	0
svgs/oxygen-icons-5.113.0/scalable/mimetypes/hidef/image-x-xfig.svg	pass	136289	22831	113458	0
svgs/oxygen-icons-5.113.0/scalable/mimetypes/hidef/inode-directory.svg	pass	138076	122644	15432	0
svgs/oxygen-icons-5.113.0/scalable/mimetypes/hidef/message-news.svg	pass	275669	9508	266161	1
svgs/oxygen-icons-5.113.0/scalable/mimetypes/hidef/message-partial.svg	pass	922859	428710	494149	1
svgs/oxygen-icons-5.113.0/scalable/mimetypes/hidef/message-rfc822.svg	pass	900786	426926	473860	4
svgs/oxygen-icons-5.113.0/scalable/mimetypes/hidef/message-x-gnu-rmail.svg	pass	900786	426926	473860	4
svgs/oxygen-icons-5.113.0/scalable/mimetypes/hidef/message.svg	pass	900786	426926	473860	4
svgs/oxygen-icons-5.113.0/scalable/mimetypes/hidef/mime2.svg	pass	46488	6556	39932	0
svgs/oxygen-icons-5.113.0/scalable/mimetypes/hidef/package-x-generic.svg	pass	103784	35627	68157	0
svgs/oxygen-icons-5.113.0/scalable/mimetypes/hidef/text-calendar.svg	pass	143498	37672	105826	0
svgs/oxygen-icons-5.113.0/scalable/mimetypes/hidef/text-css.svg	pass	1918246	877530	1040716	0
svgs/oxygen-icons-5.113.0/scalable/mimetypes/hidef/text-csv.svg	pass	100864	28034	72830	0
svgs/oxygen-icons-5.113.0/scalable/mimetypes/hidef/text-directory.svg	pass	585902	57658	528244	0
svgs/oxygen-icons-5.113.0/scalable/mimetypes/hidef/text-enriched.svg	pass	247329	135530	111799	0
svgs/oxygen-icons-5.113.0/scalable/mimetypes/hidef/text-html.svg	pass	3409766	1768055	1641711	0
svgs/oxygen-icons-5.113.0/scalable/mimetypes/hidef/text-mathml.svg	pass	321711	170434	151277	0
svgs/oxygen-icons-5.113.0/scalable/mimetypes/hidef/text-plain.svg	pass	187819	115027	72792	0
svgs/oxygen-icons-5.113.0/scalable/mimetypes/hidef/text-rdf+xml.svg	pass	2644990	1418188	1226802	0
svgs/oxygen-icons-5.113.0/scalable/mimetypes/hidef/text-rdf.svg	pass	2644990	1418188	1226802	0
svgs/oxygen-icons-5.113.0/scalable/mimetypes/hidef/text-rtf.svg	pass	1492671	882620	610051	0
svgs/oxygen-icons-5.113.0/scalable/mimetypes/hidef/text-sgml.svg	pass	491405	215208	276197	0
svgs/oxygen-icons-5.113.0/scalable/mimetypes/hidef/text-troff.svg	pass	1909215	1699651	209564	0
svgs/oxygen-icons-5.113.0/scalable/mimetypes/hidef/text-vcalendar.svg	pass	295113	156898	138215	0
svgs/oxygen-icons-5.113.0/scalable/mimetypes/hidef/text-vnd.abc.svg	pass	645945	238323	407622	0
svgs/oxygen-icons-5.113.0/scalable/mimetypes/hidef/text-vnd.wap.wml.svg	pass	1675639	603703	1071936	0
svgs/oxygen-icons-5.113.0/scalable/mimetypes/hidef/text-x-adasrc.svg	pass	95046	25897	69149	0
svgs/oxygen-icons-5.113.0/scalable/mimetypes/hidef/text-x-authors.svg	pass	506648	221444	285204	0
svgs/oxygen-icons-5.113.0/scalable/mimetypes/hidef/text-x-bibtex.svg	pass	60044	14371	45673	0
svgs/oxygen-icons-5.113.0/scalable/mimetypes/hidef/text-x-c++hdr.svg	pass	97194	24026	73168	0
svgs/oxygen-icons-5.113.0/scalable/mimetypes/hidef/text-x-c++src.svg	pass	80400	21856	58544	0
svgs/oxygen-icons-5.113.0/scalable/mimetypes/hidef/text-x-changelog.svg	pass	187819	115027	72792	0
svgs/oxygen-icons-5.113.0/scalable/mimetypes/hidef/text-x-chdr.svg	pass	88238	18229	70009	0
svgs/oxygen-icons-5.113.0/scalable/mimetypes/hidef/text-x-cmake.svg	pass	558821	252041	306780	0
svgs/oxygen-icons-5.113.0/scalable/mimetypes/hidef/text-x-copying.png.svg	pass	570539	225796	344743	0
svgs/oxygen-icons-5.113.0/scalable/mimetypes/hidef/text-x-copying.svg	pass	570535	225796	344739	0
svgs/oxygen-icons-5.113.0/scalable/mimetypes/hidef/text-x-csharp.svg	pass	100806	33617	67189	0
svgs/oxygen-icons-5.113.0/scalable/mimetypes/hidef/text-x-csrc.svg	pass	75995	22060	53935	0
svgs/oxygen-icons-5.113.0/scalable/mimetypes/hidef/text-x-dtd.svg	pass	1675642	603703	1071939	0
svgs/oxygen-icons-5.113.0/scalable/mimetypes/hidef/text-x-generic.svg	pass	491405	215208	276197	0
svgs/oxygen-icons-5.113.0/scalable/mimetypes/hidef/text-x-haskell.svg	pass	386165	188312	197853	0
svgs/oxygen-icons-5.113.0/scalable/mimetypes/hidef/text-x-hex.svg	pass	64256	13719	50537	0
svgs/oxygen-icons-5.113.0/scalable/mimetypes/hidef/text-x-install.svg	pass	568520	234967	333553	0
svgs/oxygen-icons-5.113.0/scalable/mimetypes/hidef/text-x-java.svg	pass	272739	99633	173106	0
svgs/oxygen-icons-5.113.0/scalable/mimetypes/hidef/text-x-katefilelist.svg	mismatch	512045	220539	291506	247
svgs/oxygen-icons-5.113.0/scalable/mimetypes/hidef/text-x-ldif.svg	pass	1211591	190196	1021395	0
svgs/oxygen-icons-5.113.0/scalable/mimetypes/hidef/text-x-lilypond.svg	pass	553621	275497	278124	0
svgs/oxygen-icons-5.113.0/scalable/mimetypes/hidef/text-x-log-t.svg	pass	252764	134350	118414	0
svgs/oxygen-icons-5.113.0/scalable/mimetypes/hidef/text-x-log.svg	pass	250198	135917	114281	0
svgs/oxygen-icons-5.113.0/scalable/mimetypes/hidef/text-x-makefile.svg	pass	469588	171659	297929	0
svgs/oxygen-icons-5.113.0/scalable/mimetypes/hidef/text-x-nfo.svg	pass	491405	215208	276197	0
svgs/oxygen-icons-5.113.0/scalable/mimetypes/hidef/text-x-objchdr.svg	pass	88234	18229	70005	0
svgs/oxygen-icons-5.113.0/scalable/mimetypes/hidef/text-x-objcsrc.svg	pass	75995	22060	53935	0
svgs/oxygen-icons-5.113.0/scalable/mimetypes/hidef/text-x-pascal.svg	pass	2748272	2082878	665394	0
svgs/oxygen-icons-5.113.0/scalable/mimetypes/hidef/text-x-patch.svg	pass	243610	47018	196592	0
svgs/oxygen-icons-5.113.0/scalable/mimetypes/hidef/text-x-po.svg	pass	789933	524010	265923	0
svgs/oxygen-icons-5.113.0/scalable/mimetypes/hidef/text-x-python.svg	pass	129770	43564	86206	0
svgs/oxygen-icons-5.113.0/scalable/mimetypes/hidef/text-x-qml.svg	pass	80863	24806	56057	0
svgs/oxygen-icons-5.113.0/scalable/mimetypes/hidef/text-x-readme.svg	pass	604095	326916	277179	0
svgs/oxygen-icons-5.113.0/scalable/mimetypes/hidef/text-x-rpm-spec.svg	pass	106942	34122	72820	0
svgs/oxygen-icons-5.113.0/scalable/mimetypes/hidef/text-x-script.svg	pass	1931031	1060186	870845	0
svgs/oxygen-icons-5.113.0/scalable/mimetypes/hidef/text-x-sql.svg	pass	144059	39565	104494	0
svgs/oxygen-icons-5.113.0/scalable/mimetypes/hidef/text-x-tex.svg	pass	60036	14371	45665	0
svgs/oxygen-icons-5.113.0/scalable/mimetypes/hidef/text-x-texinfo.svg	pass	354715	137241	217474	0
svgs/oxygen-icons-5.113.0/scalable/mimetypes/hidef/text-x-vcard.svg	pass	552648	58827	493821	0
svgs/oxygen-icons-5.113.0/scalable/mimetypes/hidef/text-x-xslfo.svg	pass	1675642	603703	1071939	0
svgs/oxygen-icons-5.113.0/scalable/mimetypes/hidef/text-xmcd.svg	pass	165041	67612	97429	0
svgs/oxygen-icons-5.113.0/scalable/mimetypes/hidef/text-xml.svg	pass	111972	28387	83585	0
svgs/oxygen-icons-5.113.0/scalable/mimetypes/hidef/unknown.svg	pass	58865	12032	46833	0
svgs/oxygen-icons-5.113.0/scalable/mimetypes/hidef/uri-mms.svg	pass	1680169	795580	884589	0
svgs/oxygen-icons-5.113.0/scalable/mimetypes/hidef/uri-mmst.svg	pass	1680169	795580	884589	0
svgs/oxygen-icons-5.113.0/scalable/mimetypes/hidef/uri-mmsu.svg	pass	1680169	795580	884589	0
svgs/oxygen-icons-5.113.0/scalable/mimetypes/hidef/uri-pnm.svg	pass	1680169	795580	884589	0
svgs/oxygen-icons-5.113.0/scalable/mimetypes/hidef/uri-rtspt.svg	pass	1680169	795580	884589	0
svgs/oxygen-icons-5.113.0/scalable/mimetypes/hidef/uri-rtspu.svg	pass	1680169	795580	884589	0
svgs/oxygen-icons-5.113.0/scalable/mimetypes/hidef/video-x-generic.svg	pass	106687	32899	73788	0
svgs/oxygen-icons-5.113.0/scalable/mimetypes/hidef/video-x-mng.svg	pass	240310	153936	86374	0
svgs/oxygen-icons-5.113.0/scalable/mimetypes/hidef/x-kde-nsplugin-generated.svg	pass	139947	45161	94786	0
svgs/oxygen-icons-5.113.0/scalable/mimetypes/hidef/x-media-podcast.svg	pass	143404	33469	109935	0
svgs/oxygen-icons-5.113.0/scalable/mimetypes/hidef/x-office-address-book.svg	pass	3024953	2351220	673733	0
svgs/oxygen-icons-5.113.0/scalable/mimetypes/hidef/x-office-calendar.svg	pass	295113	156898	138215	0
svgs/oxygen-icons-5.113.0/scalable/mimetypes/hidef/x-office-document.svg	pass	203188	125290	77898	0
svgs/oxygen-icons-5.113.0/scalable/mimetypes/hidef/x-office-spreadsheet.svg	pass	94456	23577	70879	0
svgs/oxygen-icons-5.113.0/scalable/mimetypes/image-svg+xml-compressed.svg	pass	448992	108655	340337	0
svgs/oxygen-icons-5.113.0/scalable/mimetypes/image-svg+xml.svg	pass	143538	24648	118890	0
svgs/oxygen-icons-5.113.0/scalable/mimetypes/image-vnd.dgn.svg	pass	280514	39881	240633	0
svgs/oxygen-icons-5.113.0/scalable/mimetypes/image-vnd.dwg.svg	pass	280195	39881	240314	0
svgs/oxygen-icons-5.113.0/scalable/mimetypes/image-x-adobe-dng.svg	pass	689979	556827	133152	0
svgs/oxygen-icons-5.113.0/scalable/mimetypes/image-x-eps.svg	pass	143496	24770	118726	0
svgs/oxygen-icons-5.113.0/scalable/mimetypes/image-x-generic.svg	pass	246742	155234	91508	0
svgs/oxygen-icons-5.113.0/scalable/mimetypes/image-x-vnd.trolltech.qpicture.svg	pass	144355	24780	119575	0
svgs/oxygen-icons-5.113.0/scalable/mimetypes/image-x-xfig.svg	pass	143538	24648	118890	0
svgs/oxygen-icons-5.113.0/scalable/mimetypes/inode-directory.svg	pass	135983	121336	14647	0
svgs/oxygen-icons-5.113.0/scalable/mimetypes/message-news.svg	pass	276523	9991	266532	1
svgs/oxygen-icons-5.113.0/scalable/mimetypes/message-partial.svg	pass	922861	428724	494137	1
svgs/oxygen-icons-5.113.0/scalable/mimetypes/message-rfc822.svg	pass	909212	427382	481830	3
svgs/oxygen-icons-5.113.0/scalable/mimetypes/message-x-gnu-rmail.svg	pass	909212	427382	481830	3
svgs/oxygen-icons-5.113.0/scalable/mimetypes/message.svg	pass	909212	427382	481830	3
svgs/oxygen-icons-5.113.0/scalable/mimetypes/mime2.svg	pass	46516	6546	39970	0
svgs/oxygen-icons-5.113.0/scalable/mimetypes/package-x-generic.svg	pass	109368	35805	73563	0
svgs/oxygen-icons-5.113.0/scalable/mimetypes/small/16x16/application-epub+zip.svg	pass	2783426	2319949	463477	0
svgs/oxygen-icons-5.113.0/scalable/mimetypes/small/16x16/application-illustrator.svg	pass	22879	10644	12235	0
svgs/oxygen-icons-5.113.0/scalable/mimetypes/small/16x16/application-javascript.svg	pass	32851	10158	22693	0
svgs/oxygen-icons-5.113.0/scalable/mimetypes/small/16x16/application-msword-template.svg	pass	220131	101927	118204	1
svgs/oxygen-icons-5.113.0/scalable/mimetypes/small/16x16/application-msword.svg	pass	219621	101289	118332	1
svgs/oxygen-icons-5.113.0/scalable/mimetypes/small/16x16/application-octet-stream.svg	pass	39531	13674	25857	0
svgs/oxygen-icons-5.113.0/scalable/mimetypes/small/16x16/application-pdf.svg	pass	20103	9744	10359	0
svgs/oxygen-icons-5.113.0/scalable/mimetypes/small/16x16/application-pgp-encrypted.svg	pass	191474	9861	181613	0
svgs/oxygen-icons-5.113.0/scalable/mimetypes/small/16x16/application-pgp-keys.svg	pass	465544	75015	390529	1
svgs/oxygen-icons-5.113.0/scalable/mimetypes/small/16x16/application-pkcs7-mime.svg	pass	465544	75015	390529	1
svgs/oxygen-icons-5.113.0/scalable/mimetypes/small/16x16/application-postscript.svg	pass	54338	22877	31461	0
svgs/oxygen-icons-5.113.0/scalable/mimetypes/small/16x16/application-relaxng.svg	pass	511410	202673	308737	0
svgs/oxygen-icons-5.113.0/scalable/mimetypes/small/16x16/application-rss+xml.svg	pass	22949	9857	13092	0
svgs/oxygen-icons-5.113.0/scalable/mimetypes/small/16x16/application-rtf.svg	pass	191081	118132	72949	0
svgs/oxygen-icons-5.113.0/scalable/mimetypes/small/16x16/application-sxw.svg	pass	300299	149888	150411	0
svgs/oxygen-icons-5.113.0/scalable/mimetypes/small/16x16/application-vnd-google-earth-kml.svg	pass	25453	12120	13333	0
svgs/oxygen-icons-5.113.0/scalable/mimetypes/small/16x16/application-vnd.iccprofile.svg	pass	97089	32544	64545	0
svgs/oxygen-icons-5.113.0/scalable/mimetypes/small/16x16/application-vnd.ms-access.svg	pass	84091	12971	71120	0
svgs/oxygen-icons-5.113.0/scalable/mimetypes/small/16x16/application-vnd.ms-excel.svg	pass	42953	11160	31793	0
svgs/oxygen-icons-5.113.0/scalable/mimetypes/small/16x16/application-vnd.ms-powerpoint.svg	pass	33973	12841	21132	0
svgs/oxygen-icons-5.113.0/scalable/mimetypes/small/16x16/application-vnd.oasis.opendocument.chart.svg	pass	79393	25075	54318	0
svgs/oxygen-icons-5.113.0/scalable/mimetypes/small/16x16/application-vnd.oasis.opendocument.database.svg	pass	23912	10951	12961	0
svgs/oxygen-icons-5.113.0/scalable/mimetypes/small/16x16/application-vnd.oasis.opendocument.formula-template.svg	pass	33137	9935	23202	0
svgs/oxygen-icons-5.113.0/scalable/mimetypes/small/16x16/application-vnd.oasis.opendocument.formula.svg	pass	33509	9309	24200	0
svgs/oxygen-icons-5.113.0/scalable/mimetypes/small/16x16/application-vnd.oasis.opendocument.graphics.svg	pass	39097	16347	22750	0
svgs/oxygen-icons-5.113.0/scalable/mimetypes/small/16x16/application-vnd.oasis.opendocument.image.svg	pass	145374	21895	123479	0
svgs/oxygen-icons-5.113.0/scalable/mimetypes/small/16x16/application-vnd.oasis.opendocument.presentation-template.svg	pass	103290	14620	88670	0
svgs/oxygen-icons-5.113.0/scalable/mimetypes/small/16x16/application-vnd.oasis.opendocument.presentation.svg	pass	103645	13982	89663	0
svgs/oxygen-icons-5.113.0/scalable/mimetypes/small/16x16/application-vnd.oasis.opendocument.spreadsheet-template.svg	pass	29762	10139	19623	0
svgs/oxygen-icons-5.113.0/scalable/mimetypes/small/16x16/application-vnd.oasis.opendocument.spreadsheet.svg	pass	28785	9306	19479	0
svgs/oxygen-icons-5.113.0/scalable/mimetypes/small/16x16/application-vnd.oasis.opendocument.text-template.svg	pass	193421	99616	93805	1
svgs/oxygen-icons-5.113.0/scalable/mimetypes/small/16x16/application-vnd.oasis.opendocument.text.svg	pass	216941	99243	117698	1
svgs/oxygen-icons-5.113.0/scalable/mimetypes/small/16x16/application-vnd.openxmlformats-officedocument.wordprocessingml.document.svg	pass	216941	99243	117698	1
svgs/oxygen-icons-5.113.0/scalable/mimetypes/small/16x16/application-vnd.rn-realmedia.svg	pass	216717	15779	200938	0
svgs/oxygen-icons-5.113.0/scalable/mimetypes/small/16x16/application-vnd.scribus.svg	pass	205754	10279	195475	0
svgs/oxygen-icons-5.113.0/scalable/mimetypes/small/16x16/application-vnd.stardivision.calc.svg	pass	28785	9306	19479	0
svgs/oxygen-icons-5.113.0/scalable/mimetypes/small/16x16/application-vnd.stardivision.draw.svg	pass	145374	21895	123479	0
svgs/oxygen-icons-5.113.0/scalable/mimetypes/small/16x16/application-vnd.stardivision.mail.svg	pass	108530	21121	87409	0
svgs/oxygen-icons-5.113.0/scalable/mimetypes/small/16x16/application-vnd.stardivision.math.svg	pass	33509	9309	24200	0
svgs/oxygen-icons-5.113.0/scalable/mimetypes/small/16x16/application-vnd.sun.xml.calc.svg	pass	28785	9306	19479	0
svgs/oxygen-icons-5.113.0/scalable/mimetypes/small/16x16/application-vnd.sun.xml.calc.template.svg	pass	29762	10139	19623	0
svgs/oxygen-icons-5.113.0/scalable/mimetypes/small/16x16/application-vnd.sun.xml.draw.svg	pass	145374	21895	123479	0
svgs/oxygen-icons-5.113.0/scalable/mimetypes/small/16x16/application-vnd.sun.xml.draw.template.svg	pass	158636	23685	134951	0
svgs/oxygen-icons-5.113.0/scalable/mimetypes/small/16x16/application-vnd.sun.xml.math.svg	pass	33509	9309	24200	0
svgs/oxygen-icons-5.113.0/scalable/mimetypes/small/16x16/application-vnd.wordperfect.svg	pass	218685	100754	117931	1
svgs/oxygen-icons-5.113.0/scalable/mimetypes/small/16x16/application-x-7z-compressed.svg	pass	217475	67259	150216	0
svgs/oxygen-icons-5.113.0/scalable/mimetypes/small/16x16/application-x-abiword.svg	pass	216941	99243	117698	1
svgs/oxygen-icons-5.113.0/scalable/mimetypes/small/16x16/application-x-ace.svg	pass	217475	67259	150216	0
svgs/oxygen-icons-5.113.0/scalable/mimetypes/small/16x16/application-x-applix-spreadsheet.svg	pass	28785	9306	19479	0
svgs/oxygen-icons-5.113.0/scalable/mimetypes/small/16x16/application-x-applix-word.svg	pass	201050	100401	100649	3
svgs/oxygen-icons-5.113.0/scalable/mimetypes/small/16x16/application-x-ar.svg	pass	42042	18303	23739	0
svgs/oxygen-icons-5.113.0/scalable/mimetypes/small/16x16/application-x-arc.svg	pass	217475	67259	150216	0
svgs/oxygen-icons-5.113.0/scalable/mimetypes/small/16x16/application-x-archive.svg	pass	42042	18303	23739	0
svgs/oxygen-icons-5.113.0/scalable/mimetypes/small/16x16/application-x-arj.svg	pass	217475	67259	150216	0
svgs/oxygen-icons-5.113.0/scalable/mimetypes/small/16x16/application-x-awk.svg	pass	9491	4169	5322	0
svgs/oxygen-icons-5.113.0/scalable/mimetypes/small/16x16/application-x-bittorrent.svg	pass	240686	119047	121639	0
svgs/oxygen-icons-5.113.0/scalable/mimetypes/small/16x16/application-x-blender.svg	pass	50679	21236	29443	0
svgs/oxygen-icons-5.113.0/scalable/mimetypes/small/16x16/application-x-bzdvi.svg	pass	215213	66136	149077	0
svgs/oxygen-icons-5.113.0/scalable/mimetypes/small/16x16/application-x-bzip-compressed-tar.svg	pass	217475	67259	150216	0
svgs/oxygen-icons-5.113.0/scalable/mimetypes/small/16x16/application-x-bzip.svg	pass	290690	57283	233407	0
svgs/oxygen-icons-5.113.0/scalable/mimetypes/small/16x16/application-x-cd-image.svg	pass	45153	22176	22977	0
svgs/oxygen-icons-5.113.0/scalable/mimetypes/small/16x16/application-x-cda.svg	pass	63116	30483	32633	0
svgs/oxygen-icons-5.113.0/scalable/mimetypes/small/16x16/application-x-chm.svg	pass	32117	10253	21864	0
svgs/oxygen-icons-5.113.0/scalable/mimetypes/small/16x16/application-x-compress.svg	pass	290690	57283	233407	0
svgs/oxygen-icons-5.113.0/scalable/mimetypes/small/16x16/application-x-compressed-tar.svg	pass	84195	20974	63221	1
svgs/oxygen-icons-5.113.0/scalable/mimetypes/small/16x16/application-x-cpio.svg	pass	42042	18303	23739	0
svgs/oxygen-icons-5.113.0/scalable/mimetypes/small/16x16/application-x-cue.svg	pass	294790	141904	152886	0
svgs/oxygen-icons-5.113.0/scalable/mimetypes/small/16x16/application-x-deb.svg	pass	97421	22052	75369	0
svgs/oxygen-icons-5.113.0/scalable/mimetypes/small/16x16/application-x-designer.svg	pass	109026	40929	68097	0
svgs/oxygen-icons-5.113.0/scalable/mimetypes/small/16x16/application-x-desktop.svg	pass	99919	43560	56359	2
svgs/oxygen-icons-5.113.0/scalable/mimetypes/small/16x16/application-x-egon.svg	pass	77974	38850	39124	0
svgs/oxygen-icons-5.113.0/scalable/mimetypes/small/16x16/application-x-executable-script.svg	pass	192180	46888	145292	1
svgs/oxygen-icons-5.113.0/scalable/mimetypes/small/16x16/application-x-executable.svg	pass	99919	43560	56359	2
svgs/oxygen-icons-5.113.0/scalable/mimetypes/small/16x16/application-x-font-afm.svg	pass	41205	15944	25261	0
svgs/oxygen-icons-5.113.0/scalable/mimetypes/small/16x16/application-x-font-bdf.svg	pass	34507	15810	18697	0
svgs/oxygen-icons-5.113.0/scalable/mimetypes/small/16x16/application-x-font-otf.svg	pass	50974	19290	31684	0
svgs/oxygen-icons-5.113.0/scalable/mimetypes/small/16x16/application-x-font-pcf.svg	pass	34507	15810	18697	0
svgs/oxygen-icons-5.113.0/scalable/mimetypes/small/16x16/application-x-font-snf.svg	pass	34507	15810	18697	0
svgs/oxygen-icons-5.113.0/scalable/mimetypes/small/16x16/application-x-font-ttf.svg	pass	35648	10210	25438	0
svgs/oxygen-icons-5.113.0/scalable/mimetypes/small/16x16/application-x-font-type1.svg	pass	41205	15944	25261	0
svgs/oxygen-icons-5.113.0/scalable/mimetypes/small/16x16/application-x-gnumeric.svg	pass	28785	9306	19479	0
svgs/oxygen-icons-5.113.0/scalable/mimetypes/small/16x16/application-x-gzdvi.svg	pass	215213	66136	149077	0
svgs/oxygen-icons-5.113.0/scalable/mimetypes/small/16x16/application-x-gzip.svg	pass	290690	57283	233407	0
svgs/oxygen-icons-5.113.0/scalable/mimetypes/small/16x16/application-x-gzpostscript.svg	pass	54338	22877	31461	0
svgs/oxygen-icons-5.113.0/scalable/mimetypes/small/16x16/application-x-it87.svg	pass	97089	32544	64545	0
svgs/oxygen-icons-5.113.0/scalable/mimetypes/small/16x16/application-x-java-applet.svg	pass	491212	31591	459621	0
svgs/oxygen-icons-5.113.0/scalable/mimetypes/small/16x16/application-x-java-archive.svg	pass	107713	22059	85654	0
svgs/oxygen-icons-5.113.0/scalable/mimetypes/small/16x16/application-x-java.svg	pass	491212	31591	459621	0
svgs/oxygen-icons-5.113.0/scalable/mimetypes/small/16x16/application-x-javascript.svg	pass	32851	10158	22693	0
svgs/oxygen-icons-5.113.0/scalable/mimetypes/small/16x16/application-x-k3b.svg	pass	228144	169869	58275	0
svgs/oxygen-icons-5.113.0/scalable/mimetypes/small/16x16/application-x-kcsrc.svg	pass	61977	22824	39153	0
svgs/oxygen-icons-5.113.0/scalable/mimetypes/small/16x16/application-x-kexi-connectiondata.svg	pass	43188	10131	33057	0
svgs/oxygen-icons-5.113.0/scalable/mimetypes/small/16x16/application-x-kexiproject-shortcut.svg	pass	46031	11479	34552	0
svgs/oxygen-icons-5.113.0/scalable/mimetypes/small/16x16/application-x-kexiproject-sqlite.svg	pass	23912	10951	12961	0
svgs/oxygen-icons-5.113.0/scalable/mimetypes/small/16x16/application-x-kexiproject-sqlite2.svg	pass	23912	10951	12961	0
svgs/oxygen-icons-5.113.0/scalable/mimetypes/small/16x16/application-x-kexiproject-sqlite3.svg	pass	23912	10951	12961	0
svgs/oxygen-icons-5.113.0/scalable/mimetypes/small/16x16/application-x-kformula.svg	pass	33509	9309	24200	0
svgs/oxygen-icons-5.113.0/scalable/mimetypes/small/16x16/application-x-kgetlist.svg	pass	44875	18638	26237	0
svgs/oxygen-icons-5.113.0/scalable/mimetypes/small/16x16/application-x-kontour.svg	pass	39097	16347	22750	0
svgs/oxygen-icons-5.113.0/scalable/mimetypes/small/16x16/application-x-kplato.svg	pass	27989	9746	18243	0
svgs/oxygen-icons-5.113.0/scalable/mimetypes/small/16x16/application-x-krita.svg	pass	135002	62681	72321	0
svgs/oxygen-icons-5.113.0/scalable/mimetypes/small/16x16/application-x-kword.svg	pass	216941	99243	117698	1
svgs/oxygen-icons-5.113.0/scalable/mimetypes/small/16x16/application-x-lha.svg	pass	217475	67259	150216	0
svgs/oxygen-icons-5.113.0/scalable/mimetypes/small/16x16/application-x-lyx.svg	pass	225447	73993	151454	4
svgs/oxygen-icons-5.113.0/scalable/mimetypes/small/16x16/application-x-lzma-compressed-tar.svg	pass	42042	18303	23739	0
svgs/oxygen-icons-5.113.0/scalable/mimetypes/small/16x16/application-x-lzop.svg	pass	290690	57283	233407	0
svgs/oxygen-icons-5.113.0/scalable/mimetypes/small/16x16/application-x-m4.svg	pass	115123	51303	63820	0
svgs/oxygen-icons-5.113.0/scalable/mimetypes/small/16x16/application-x-marble.svg	pass	440624	226048	214576	0
svgs/oxygen-icons-5.113.0/scalable/mimetypes/small/16x16/application-x-mimearchive.svg	pass	108530	21121	87409	0
svgs/oxygen-icons-5.113.0/scalable/mimetypes/small/16x16/application-x-mplayer2.svg	pass	216717	15779	200938	0
svgs/oxygen-icons-5.113.0/scalable/mimetypes/small/16x16/application-x-ms-dos-executable.svg	pass	192180	46888	145292	1
svgs/oxygen-icons-5.113.0/scalable/mimetypes/small/16x16/application-x-mswinurl.svg	pass	783030	365131	417899	0
svgs/oxygen-icons-5.113.0/scalable/mimetypes/small/16x16/application-x-mswrite.svg	pass	331661	195823	135838	4
svgs/oxygen-icons-5.113.0/scalable/mimetypes/small/16x16/application-x-nzb.svg	pass	67010	35029	31981	0
svgs/oxygen-icons-5.113.0/scalable/mimetypes/small/16x16/application-x-object.svg	pass	39531	13674	25857	0
svgs/oxygen-icons-5.113.0/scalable/mimetypes/small/16x16/application-x-pak.svg	pass	290690	57283	233407	0
svgs/oxygen-icons-5.113.0/scalable/mimetypes/small/16x16/application-x-pem-key.svg	pass	465544	75015	390529	1
svgs/oxygen-icons-5.113.0/scalable/mimetypes/small/16x16/application-x-perl.svg	pass	448978	258857	190121	0
svgs/oxygen-icons-5.113.0/scalable/mimetypes/small/16x16/application-x-php.svg	pass	47510	14042	33468	0
svgs/oxygen-icons-5.113.0/scalable/mimetypes/small/16x16/application-x-plasma.svg	pass	69329	28010	41319	0
svgs/oxygen-icons-5.113.0/scalable/mimetypes/small/16x16/application-x-python-bytecode.svg	pass	39531	13674	25857	0
svgs/oxygen-icons-5.113.0/scalable/mimetypes/small/16x16/application-x-python.svg	pass	14728	6938	7790	0
svgs/oxygen-icons-5.113.0/scalable/mimetypes/small/16x16/application-x-qet-element.svg	pass	463636	118193	345443	0
svgs/oxygen-icons-5.113.0/scalable/mimetypes/small/16x16/application-x-qet-project.svg	pass	462660	118044	344616	0
svgs/oxygen-icons-5.113.0/scalable/mimetypes/small/16x16/application-x-quattropro.svg	pass	28785	9306	19479	0
svgs/oxygen-icons-5.113.0/scalable/mimetypes/small/16x16/application-x-rar.svg	pass	217475	67259	150216	0
svgs/oxygen-icons-5.113.0/scalable/mimetypes/small/16x16/application-x-rpm.svg	pass	67804	21484	46320	2
svgs/oxygen-icons-5.113.0/scalable/mimetypes/small/16x16/application-x-ruby.svg	pass	112377	27386	84991	0
svgs/oxygen-icons-5.113.0/scalable/mimetypes/small/16x16/application-x-sharedlib.svg	pass	39531	13674	25857	0
svgs/oxygen-icons-5.113.0/scalable/mimetypes/small/16x16/application-x-shellscript.svg	pass	20900	8225	12675	0
svgs/oxygen-icons-5.113.0/scalable/mimetypes/small/16x16/application-x-shockwave-flash.svg	pass	216717	15779	200938	0
svgs/oxygen-icons-5.113.0/scalable/mimetypes/small/16x16/application-x-siag.svg	pass	28785	9306	19479	0
svgs/oxygen-icons-5.113.0/scalable/mimetypes/small/16x16/application-x-sqlite2.svg	pass	23912	10951	12961	0
svgs/oxygen-icons-5.113.0/scalable/mimetypes/small/16x16/application-x-sqlite3.svg	pass	23912	10951	12961	0
svgs/oxygen-icons-5.113.0/scalable/mimetypes/small/16x16/application-x-srt.svg	pass	317716	224773	92943	0
svgs/oxygen-icons-5.113.0/scalable/mimetypes/small/16x16/application-x-srtrip.svg	pass	317716	224773	92943	0
svgs/oxygen-icons-5.113.0/scalable/mimetypes/small/16x16/application-x-subrip.svg	pass	317716	224773	92943	0
svgs/oxygen-icons-5.113.0/scalable/mimetypes/small/16x16/application-x-tar.svg	pass	42042	18303	23739	0
svgs/oxygen-icons-5.113.0/scalable/mimetypes/small/16x16/application-x-tarz.svg	pass	217475	67259	150216	0
svgs/oxygen-icons-5.113.0/scalable/mimetypes/small/16x16/application-x-tgif.svg	pass	39097	16347	22750	0
svgs/oxygen-icons-5.113.0/scalable/mimetypes/small/16x16/application-x-trash.svg	pass	49643	20684	28959	0
svgs/oxygen-icons-5.113.0/scalable/mimetypes/small/16x16/application-x-troff-man.svg	pass	2815335	2327797	487538	0
svgs/oxygen-icons-5.113.0/scalable/mimetypes/small/16x16/application-x-tzo.svg	pass	217475	67259	150216	0
svgs/oxygen-icons-5.113.0/scalable/mimetypes/small/16x16/application-x-wmf.svg	pass	39097	16347	22750	0
svgs/oxygen-icons-5.113.0/scalable/mimetypes/small/16x16/application-x-zerosize.svg	pass	16522	7637	8885	0
svgs/oxygen-icons-5.113.0/scalable/mimetypes/small/16x16/application-x-zip.svg	pass	205951	62563	143388	0
svgs/oxygen-icons-5.113.0/scalable/mimetypes/small/16x16/application-x-zoo.svg	pass	217475	67259	150216	0
svgs/oxygen-icons-5.113.0/scalable/mimetypes/small/16x16/application-xhtml+xml.svg	pass	108314	9639	98675	0
svgs/oxygen-icons-5.113.0/scalable/mimetypes/small/16x16/application-xml.svg	pass	108314	9639	98675	0
svgs/oxygen-icons-5.113.0/scalable/mimetypes/small/16x16/application-xsd.svg	pass	653614	272912	380702	1
svgs/oxygen-icons-5.113.0/scalable/mimetypes/small/16x16/application-xslt+xml.svg	pass	783030	365131	417899	0
svgs/oxygen-icons-5.113.0/scalable/mimetypes/small/16x16/application-zip.svg	pass	217475	67259	150216	0
svgs/oxygen-icons-5.113.0/scalable/mimetypes/small/16x16/audio-ac3.svg	pass	40425	16273	24152	0
svgs/oxygen-icons-5.113.0/scalable/mimetypes/small/16x16/audio-midi.svg	pass	42088	16568	25520	0
svgs/oxygen-icons-5.113.0/scalable/mimetypes/small/16x16/audio-prs.sid.svg	pass	42088	16568	25520	0
svgs/oxygen-icons-5.113.0/scalable/mimetypes/small/16x16/audio-vn.rn-realmedia.svg	pass	216717	15779	200938	0
svgs/oxygen-icons-5.113.0/scalable/mimetypes/small/16x16/audio-vnd.rn-realvideo.svg	pass	216717	15779	200938	0
svgs/oxygen-icons-5.113.0/scalable/mimetypes/small/16x16/audio-x-adpcm.svg	pass	40425	16273	24152	0
svgs/oxygen-icons-5.113.0/scalable/mimetypes/small/16x16/audio-x-aiff.svg	pass	40425	16273	24152	0
svgs/oxygen-icons-5.113.0/scalable/mimetypes/small/16x16/audio-x-flac+ogg.svg	pass	40425	16273	24152	0
svgs/oxygen-icons-5.113.0/scalable/mimetypes/small/16x16/audio-x-flac.svg	pass	40425	16273	24152	0
svgs/oxygen-icons-5.113.0/scalable/mimetypes/small/16x16/audio-x-generic.svg	pass	40425	16273	24152	0
svgs/oxygen-icons-5.113.0/scalable/mimetypes/small/16x16/audio-x-monkey.svg	pass	40425	16273	24152	0
svgs/oxygen-icons-5.113.0/scalable/mimetypes/small/16x16/audio-x-speex+ogg.svg	pass	130203	61370	68833	0
svgs/oxygen-icons-5.113.0/scalable/mimetypes/small/16x16/audio-x-wav.svg	pass	40425	16273	24152	0
svgs/oxygen-icons-5.113.0/scalable/mimetypes/small/16x16/encrypted.svg	pass	465544	75015	390529	1
svgs/oxygen-icons-5.113.0/scalable/mimetypes/small/16x16/image-svg+xml-compressed.svg	pass	39097	16347	22750	0
svgs/oxygen-icons-5.113.0/scalable/mimetypes/small/16x16/image-svg+xml.svg	pass	39097	16347	22750	0
svgs/oxygen-icons-5.113.0/scalable/mimetypes/small/16x16/image-vnd.dgn.svg	pass	39347	8426	30921	0
svgs/oxygen-icons-5.113.0/scalable/mimetypes/small/16x16/image-vnd.dwg.svg	pass	31052	9080	21972	0
svgs/oxygen-icons-5.113.0/scalable/mimetypes/small/16x16/image-x-adobe-dng.svg	pass	77974	38850	39124	0
svgs/oxygen-icons-5.113.0/scalable/mimetypes/small/16x16/image-x-eps.svg	pass	37811	16179	21632	0
svgs/oxygen-icons-5.113.0/scalable/mimetypes/small/16x16/image-x-generic.svg	pass	77974	38850	39124	0
svgs/oxygen-icons-5.113.0/scalable/mimetypes/small/16x16/image-x-vnd.trolltech.qpicture.svg	pass	38151	16339	21812	0
svgs/oxygen-icons-5.113.0/scalable/mimetypes/small/16x16/image-x-xfig.svg	pass	39097	16347	22750	0
svgs/oxygen-icons-5.113.0/scalable/mimetypes/small/16x16/inode-directory.svg	pass	243394	116130	127264	0
svgs/oxygen-icons-5.113.0/scalable/mimetypes/small/16x16/message-news.svg	pass	111760	9086	102674	0
svgs/oxygen-icons-5.113.0/scalable/mimetypes/small/16x16/message-partial.svg	pass	113212	21519	91693	0
svgs/oxygen-icons-5.113.0/scalable/mimetypes/small/16x16/message-rfc822.svg	pass	108530	21121	87409	0
svgs/oxygen-icons-5.113.0/scalable/mimetypes/small/16x16/message-x-gnu-rmail.svg	pass	108530	21121	87409	0
svgs/oxygen-icons-5.113.0/scalable/mimetypes/small/16x16/message.svg	pass	108530	21121	87409	0
svgs/oxygen-icons-5.113.0/scalable/mimetypes/small/16x16/package-x-generic.svg	pass	42042	18303	23739	0
svgs/oxygen-icons-5.113.0/scalable/mimetypes/small/16x16/text-calendar.svg	pass	25023	9717	15306	0
svgs/oxygen-icons-5.113.0/scalable/mimetypes/small/16x16/text-css.svg	pass	317716	224773	92943	0
svgs/oxygen-icons-5.113.0/scalable/mimetypes/small/16x16/text-csv.svg	pass	28785	9306	19479	0
svgs/oxygen-icons-5.113.0/scalable/mimetypes/small/16x16/text-directory.svg	pass	81652	39051	42601	0
svgs/oxygen-icons-5.113.0/scalable/mimetypes/small/16x16/text-enriched.svg	pass	191081	118132	72949	0
svgs/oxygen-icons-5.113.0/scalable/mimetypes/small/16x16/text-html.svg	pass	783030	365131	417899	0
svgs/oxygen-icons-5.113.0/scalable/mimetypes/small/16x16/text-mathml.svg	pass	32272	9029	23243	0
svgs/oxygen-icons-5.113.0/scalable/mimetypes/small/16x16/text-plain.svg	pass	317716	224773	92943	0
svgs/oxygen-icons-5.113.0/scalable/mimetypes/small/16x16/text-rdf+xml.svg	pass	29886	10745	19141	0
svgs/oxygen-icons-5.113.0/scalable/mimetypes/small/16x16/text-rdf.svg	pass	29863	10745	19118	0
svgs/oxygen-icons-5.113.0/scalable/mimetypes/small/16x16/text-rtf.svg	pass	201050	100401	100649	3
svgs/oxygen-icons-5.113.0/scalable/mimetypes/small/16x16/text-sgml.svg	pass	191081	118132	72949	0
svgs/oxygen-icons-5.113.0/scalable/mimetypes/small/16x16/text-troff.svg	pass	2815335	2327797	487538	0
svgs/oxygen-icons-5.113.0/scalable/mimetypes/small/16x16/text-vcalendar.svg	pass	25023	9717	15306	0
svgs/oxygen-icons-5.113.0/scalable/mimetypes/small/16x16/text-vnd.abc.svg	pass	40425	16273	24152	0
svgs/oxygen-icons-5.113.0/scalable/mimetypes/small/16x16/text-vnd.wap.wml.svg	pass	511410	202673	308737	0
svgs/oxygen-icons-5.113.0/scalable/mimetypes/small/16x16/text-x-adasrc.svg	pass	11430	4442	6988	0
svgs/oxygen-icons-5.113.0/scalable/mimetypes/small/16x16/text-x-authors.svg	pass	191081	118132	72949	0
svgs/oxygen-icons-5.113.0/scalable/mimetypes/small/16x16/text-x-bibtex.svg	pass	19723	9763	9960	0
svgs/oxygen-icons-5.113.0/scalable/mimetypes/small/16x16/text-x-c++hdr.svg	pass	31077	8898	22179	0
svgs/oxygen-icons-5.113.0/scalable/mimetypes/small/16x16/text-x-c++src.svg	pass	52982	9459	43523	0
svgs/oxygen-icons-5.113.0/scalable/mimetypes/small/16x16/text-x-changelog.svg	pass	317716	224773	92943	0
svgs/oxygen-icons-5.113.0/scalable/mimetypes/small/16x16/text-x-chdr.svg	pass	31997	8710	23287	0
svgs/oxygen-icons-5.113.0/scalable/mimetypes/small/16x16/text-x-cmake.svg	pass	191081	118132	72949	0
svgs/oxygen-icons-5.113.0/scalable/mimetypes/small/16x16/text-x-copying.svg	pass	191081	118132	72949	0
svgs/oxygen-icons-5.113.0/scalable/mimetypes/small/16x16/text-x-csharp.svg	pass	51307	9703	41604	0
svgs/oxygen-icons-5.113.0/scalable/mimetypes/small/16x16/text-x-csrc.svg	pass	73283	9378	63905	0
svgs/oxygen-icons-5.113.0/scalable/mimetypes/small/16x16/text-x-dtd.svg	pass	511410	202673	308737	0
svgs/oxygen-icons-5.113.0/scalable/mimetypes/small/16x16/text-x-generic.svg	pass	191081	118132	72949	0
svgs/oxygen-icons-5.113.0/scalable/mimetypes/small/16x16/text-x-haskell.svg	pass	193495	104918	88577	0
svgs/oxygen-icons-5.113.0/scalable/mimetypes/small/16x16/text-x-hex.svg	pass	46483	19955	26528	0
svgs/oxygen-icons-5.113.0/scalable/mimetypes/small/16x16/text-x-install.svg	pass	191081	118132	72949	0
svgs/oxygen-icons-5.113.0/scalable/mimetypes/small/16x16/text-x-java.svg	pass	491212	31591	459621	0
svgs/oxygen-icons-5.113.0/scalable/mimetypes/small/16x16/text-x-katefilelist.svg	pass	191081	118132	72949	0
svgs/oxygen-icons-5.113.0/scalable/mimetypes/small/16x16/text-x-ldif.svg	pass	82250	39244	43006	0
svgs/oxygen-icons-5.113.0/scalable/mimetypes/small/16x16/text-x-lilypond.svg	pass	34567	15303	19264	0
svgs/oxygen-icons-5.113.0/scalable/mimetypes/small/16x16/text-x-log.svg	pass	191081	118132	72949	0
svgs/oxygen-icons-5.113.0/scalable/mimetypes/small/16x16/text-x-makefile.svg	pass	115130	51303	63827	0
svgs/oxygen-icons-5.113.0/scalable/mimetypes/small/16x16/text-x-nfo.svg	pass	191081	118132	72949	0
svgs/oxygen-icons-5.113.0/scalable/mimetypes/small/16x16/text-x-objchdr.svg	pass	31997	8710	23287	0
svgs/oxygen-icons-5.113.0/scalable/mimetypes/small/16x16/text-x-objcsrc.svg	pass	73283	9378	63905	0
svgs/oxygen-icons-5.113.0/scalable/mimetypes/small/16x16/text-x-pascal.svg	pass	1336675	1042698	293977	0
svgs/oxygen-icons-5.113.0/scalable/mimetypes/small/16x16/text-x-patch.svg	pass	201328	39474	161854	0
svgs/oxygen-icons-5.113.0/scalable/mimetypes/small/16x16/text-x-po.svg	pass	171641	113383	58258	0
svgs/oxygen-icons-5.113.0/scalable/mimetypes/small/16x16/text-x-python.svg	pass	73272	41267	32005	0
svgs/oxygen-icons-5.113.0/scalable/mimetypes/small/16x16/text-x-qml.svg	pass	47894	20411	27483	0
svgs/oxygen-icons-5.113.0/scalable/mimetypes/small/16x16/text-x-readme.svg	pass	191081	118132	72949	0
svgs/oxygen-icons-5.113.0/scalable/mimetypes/small/16x16/text-x-rpm-spec.svg	pass	58718	18782	39936	0
svgs/oxygen-icons-5.113.0/scalable/mimetypes/small/16x16/text-x-script.svg	pass	20900	8225	12675	0
svgs/oxygen-icons-5.113.0/scalable/mimetypes/small/16x16/text-x-sql.svg	pass	88287	19756	68531	2
svgs/oxygen-icons-5.113.0/scalable/mimetypes/small/16x16/text-x-tcl.svg	pass	8642	3658	4984	0
svgs/oxygen-icons-5.113.0/scalable/mimetypes/small/16x16/text-x-tex.svg	pass	19723	9763	9960	0
svgs/oxygen-icons-5.113.0/scalable/mimetypes/small/16x16/text-x-texinfo.svg	pass	44690	16577	28113	0
svgs/oxygen-icons-5.113.0/scalable/mimetypes/small/16x16/text-x-vcard.svg	pass	82250	39244	43006	0
svgs/oxygen-icons-5.113.0/scalable/mimetypes/small/16x16/text-x-xslfo.svg	pass	511410	202673	308737	0
svgs/oxygen-icons-5.113.0/scalable/mimetypes/small/16x16/text-xmcd.svg	pass	63116	30483	32633	0
svgs/oxygen-icons-5.113.0/scalable/mimetypes/small/16x16/text-xml.svg	pass	108314	9639	98675	0
svgs/oxygen-icons-5.113.0/scalable/mimetypes/small/16x16/unknown.svg	pass	58393	28275	30118	0
svgs/oxygen-icons-5.113.0/scalable/mimetypes/small/16x16/uri-mms.svg	pass	216717	15779	200938	0
svgs/oxygen-icons-5.113.0/scalable/mimetypes/small/16x16/uri-mmst.svg	pass	216717	15779	200938	0
svgs/oxygen-icons-5.113.0/scalable/mimetypes/small/16x16/uri-mmsu.svg	pass	216717	15779	200938	0
svgs/oxygen-icons-5.113.0/scalable/mimetypes/small/16x16/uri-pnm.svg	pass	216717	15779	200938	0
svgs/oxygen-icons-5.113.0/scalable/mimetypes/small/16x16/uri-rtspt.svg	pass	216717	15779	200938	0
svgs/oxygen-icons-5.113.0/scalable/mimetypes/small/16x16/uri-rtspu.svg	pass	216717	15779	200938	0
svgs/oxygen-icons-5.113.0/scalable/mimetypes/small/16x16/video-x-generic.svg	pass	216717	15779	200938	0
svgs/oxygen-icons-5.113.0/scalable/mimetypes/small/16x16/video-x-mng.svg	pass	77974	38850	39124	0
svgs/oxygen-icons-5.113.0/scalable/mimetypes/small/16x16/x-kde-nsplugin-generated.svg	pass	47786	20866	26920	0
svgs/oxygen-icons-5.113.0/scalable/mimetypes/small/16x16/x-media-podcast.svg	pass	85108	34029	51079	0
svgs/oxygen-icons-5.113.0/scalable/mimetypes/small/16x16/x-office-address-book.svg	pass	2985422	2323974	661448	0
svgs/oxygen-icons-5.113.0/scalable/mimetypes/small/16x16/x-office-calendar.svg	pass	25023	9717	15306	0
svgs/oxygen-icons-5.113.0/scalable/mimetypes/small/16x16/x-office-contact.svg	pass	117798	46049	71749	1
svgs/oxygen-icons-5.113.0/scalable/mimetypes/small/16x16/x-office-document.svg	pass	17734	7909	9825	0
svgs/oxygen-icons-5.113.0/scalable/mimetypes/small/16x16/x-office-presentation.svg	pass	103645	13982	89663	0
svgs/oxygen-icons-5.113.0/scalable/mimetypes/small/16x16/x-office-spreadsheet.svg	pass	28785	9306	19479	0
svgs/oxygen-icons-5.113.0/scalable/mimetypes/small/22x22/application-epub+zip.svg	pass	2785485	2319143	466342	0
svgs/oxygen-icons-5.113.0/scalable/mimetypes/small/22x22/application-illustrator.svg	pass	25295	12364	12931	0
svgs/oxygen-icons-5.113.0/scalable/mimetypes/small/22x22/application-javascript.svg	mismatch	91934	37668	54266	13
svgs/oxygen-icons-5.113.0/scalable/mimetypes/small/22x22/application-msword-template.svg	pass	266597	133079	133518	0
svgs/oxygen-icons-5.113.0/scalable/mimetypes/small/22x22/application-msword.svg	pass	232947	126041	106906	0
svgs/oxygen-icons-5.113.0/scalable/mimetypes/small/22x22/application-octet-stream.svg	pass	58550	16043	42507	0
svgs/oxygen-icons-5.113.0/scalable/mimetypes/small/22x22/application-pdf.svg	mismatch	21790	10465	11325	11
svgs/oxygen-icons-5.113.0/scalable/mimetypes/small/22x22/application-pgp-encrypted.svg	pass	185304	19074	166230	0
svgs/oxygen-icons-5.113.0/scalable/mimetypes/small/22x22/application-pgp-keys.svg	pass	409134	77919	331215	0
svgs/oxygen-icons-5.113.0/scalable/mimetypes/small/22x22/application-pkcs7-mime.svg	pass	409134	77919	331215	0
svgs/oxygen-icons-5.113.0/scalable/mimetypes/small/22x22/application-postscript.svg	pass	49270	22455	26815	1
svgs/oxygen-icons-5.113.0/scalable/mimetypes/small/22x22/application-relaxng.svg	pass	999177	395903	603274	0
svgs/oxygen-icons-5.113.0/scalable/mimetypes/small/22x22/application-rss+xml.svg	pass	22949	9857	13092	0
svgs/oxygen-icons-5.113.0/scalable/mimetypes/small/22x22/application-rtf.svg	pass	189377	118347	71030	0
svgs/oxygen-icons-5.113.0/scalable/mimetypes/small/22x22/application-sxw.svg	pass	373202	151944	221258	0
svgs/oxygen-icons-5.113.0/scalable/mimetypes/small/22x22/application-vnd-google-earth-kml.svg	pass	22672	10444	12228	0
svgs/oxygen-icons-5.113.0/scalable/mimetypes/small/22x22/application-vnd.iccprofile.svg	pass	98119	32638	65481	0
svgs/oxygen-icons-5.113.0/scalable/mimetypes/small/22x22/application-vnd.ms-access.svg	pass	50684	18750	31934	1
svgs/oxygen-icons-5.113.0/scalable/mimetypes/small/22x22/application-vnd.ms-excel.svg	pass	68177	12893	55284	0
svgs/oxygen-icons-5.113.0/scalable/mimetypes/small/22x22/application-vnd.ms-powerpoint.svg	pass	131135	16457	114678	0
svgs/oxygen-icons-5.113.0/scalable/mimetypes/small/22x22/application-vnd.oasis.opendocument.chart.svg	pass	95310	38211	57099	0
svgs/oxygen-icons-5.113.0/scalable/mimetypes/small/22x22/application-vnd.oasis.opendocument.database.svg	pass	124504	33225	91279	0
svgs/oxygen-icons-5.113.0/scalable/mimetypes/small/22x22/application-vnd.oasis.opendocument.formula-template.svg	pass	65585	19503	46082	0
svgs/oxygen-icons-5.113.0/scalable/mimetypes/small/22x22/application-vnd.oasis.opendocument.formula.svg	pass	53391	13197	40194	0
svgs/oxygen-icons-5.113.0/scalable/mimetypes/small/22x22/application-vnd.oasis.opendocument.graphics.svg	pass	35191	16503	18688	0
svgs/oxygen-icons-5.113.0/scalable/mimetypes/small/22x22/application-vnd.oasis.opendocument.image.svg	pass	140653	22369	118284	0
svgs/oxygen-icons-5.113.0/scalable/mimetypes/small/22x22/application-vnd.oasis.opendocument.presentation-template.svg	pass	208367	22784	185583	0
svgs/oxygen-icons-5.113.0/scalable/mimetypes/small/22x22/application-vnd.oasis.opendocument.presentation.svg	pass	103645	14697	88948	0
svgs/oxygen-icons-5.113.0/scalable/mimetypes/small/22x22/application-vnd.oasis.opendocument.spreadsheet-template.svg	pass	45434	18338	27096	0
svgs/oxygen-icons-5.113.0/scalable/mimetypes/small/22x22/application-vnd.oasis.opendocument.spreadsheet.svg	pass	32369	12003	20366	0
svgs/oxygen-icons-5.113.0/scalable/mimetypes/small/22x22/application-vnd.oasis.opendocument.text.svg	pass	289892	142395	147497	0
svgs/oxygen-icons-5.113.0/scalable/mimetypes/small/22x22/application-vnd.openxmlformats-officedocument.wordprocessingml.document.svg	pass	289892	142395	147497	0
svgs/oxygen-icons-5.113.0/scalable/mimetypes/small/22x22/application-vnd.rn-realmedia.svg	pass	51681	21132	30549	4
svgs/oxygen-icons-5.113.0/scalable/mimetypes/small/22x22/application-vnd.scribus.svg	pass	37457	17882	19575	0
svgs/oxygen-icons-5.113.0/scalable/mimetypes/small/22x22/application-vnd.stardivision.calc.svg	pass	32369	12003	20366	0
svgs/oxygen-icons-5.113.0/scalable/mimetypes/small/22x22/application-vnd.stardivision.draw.svg	pass	140607	22369	118238	0
svgs/oxygen-icons-5.113.0/scalable/mimetypes/small/22x22/application-vnd.stardivision.math.svg	pass	53329	13197	40132	0
svgs/oxygen-icons-5.113.0/scalable/mimetypes/small/22x22/application-vnd.sun.xml.calc.svg	pass	32369	12003	20366	0
svgs/oxygen-icons-5.113.0/scalable/mimetypes/small/22x22/application-vnd.sun.xml.calc.template.svg	pass	45365	18338	27027	0
svgs/oxygen-icons-5.113.0/scalable/mimetypes/small/22x22/application-vnd.sun.xml.draw.svg	pass	140607	22369	118238	0
svgs/oxygen-icons-5.113.0/scalable/mimetypes/small/22x22/application-vnd.sun.xml.draw.template.svg	pass	152952	28727	124225	0
svgs/oxygen-icons-5.113.0/scalable/mimetypes/small/22x22/application-vnd.sun.xml.math.svg	pass	53329	13197	40132	0
svgs/oxygen-icons-5.113.0/scalable/mimetypes/small/22x22/application-vnd.sun.xml.svg	pass	140608	12526	128082	0
svgs/oxygen-icons-5.113.0/scalable/mimetypes/small/22x22/application-vnd.wordperfect.svg	pass	231636	125254	106382	0
svgs/oxygen-icons-5.113.0/scalable/mimetypes/small/22x22/application-x-7z-compressed.svg	pass	193232	84233	108999	0
svgs/oxygen-icons-5.113.0/scalable/mimetypes/small/22x22/application-x-abiword.svg	pass	289892	142395	147497	0
svgs/oxygen-icons-5.113.0/scalable/mimetypes/small/22x22/application-x-ace.svg	pass	193232	84233	108999	0
svgs/oxygen-icons-5.113.0/scalable/mimetypes/small/22x22/application-x-applix-spreadsheet.svg	pass	32369	12003	20366	0
svgs/oxygen-icons-5.113.0/scalable/mimetypes/small/22x22/application-x-applix-word.svg	pass	270018	142232	127786	0
svgs/oxygen-icons-5.113.0/scalable/mimetypes/small/22x22/application-x-ar.svg	pass	49266	20064	29202	0
svgs/oxygen-icons-5.113.0/scalable/mimetypes/small/22x22/application-x-arc.svg	pass	193232	84233	108999	0
svgs/oxygen-icons-5.113.0/scalable/mimetypes/small/22x22/application-x-archive.svg	pass	49266	20064	29202	0
svgs/oxygen-icons-5.113.0/scalable/mimetypes/small/22x22/application-x-arj.svg	pass	193232	84233	108999	0
svgs/oxygen-icons-5.113.0/scalable/mimetypes/small/22x22/application-x-awk.svg	pass	38716	14021	24695	0
svgs/oxygen-icons-5.113.0/scalable/mimetypes/small/22x22/application-x-bittorrent.svg	pass	240698	119169	121529	0
svgs/oxygen-icons-5.113.0/scalable/mimetypes/small/22x22/application-x-blender.svg	pass	49502	20803	28699	0
svgs/oxygen-icons-5.113.0/scalable/mimetypes/small/22x22/application-x-bzdvi.svg	pass	191045	83110	107935	0
svgs/oxygen-icons-5.113.0/scalable/mimetypes/small/22x22/application-x-bzip-compressed-tar.svg	pass	193232	84233	108999	0
svgs/oxygen-icons-5.113.0/scalable/mimetypes/small/22x22/application-x-bzip.svg	pass	141309	57312	83997	0
svgs/oxygen-icons-5.113.0/scalable/mimetypes/small/22x22/application-x-cd-image.svg	pass	53602	22755	30847	0
svgs/oxygen-icons-5.113.0/scalable/mimetypes/small/22x22/application-x-cda.svg	pass	68808	31410	37398	0
svgs/oxygen-icons-5.113.0/scalable/mimetypes/small/22x22/application-x-chm.svg	pass	28999	10279	18720	0
svgs/oxygen-icons-5.113.0/scalable/mimetypes/small/22x22/application-x-compress.svg	pass	141309	57312	83997	0
svgs/oxygen-icons-5.113.0/scalable/mimetypes/small/22x22/application-x-compressed-tar.svg	pass	86163	22703	63460	1
svgs/oxygen-icons-5.113.0/scalable/mimetypes/small/22x22/application-x-cpio.svg	pass	49266	20064	29202	0
svgs/oxygen-icons-5.113.0/scalable/mimetypes/small/22x22/application-x-cue.svg	pass	295294	141903	153391	0
svgs/oxygen-icons-5.113.0/scalable/mimetypes/small/22x22/application-x-deb.svg	pass	76733	23076	53657	0
svgs/oxygen-icons-5.113.0/scalable/mimetypes/small/22x22/application-x-designer.svg	pass	130538	40831	89707	0
svgs/oxygen-icons-5.113.0/scalable/mimetypes/small/22x22/application-x-desktop.svg	pass	99930	43551	56379	0
svgs/oxygen-icons-5.113.0/scalable/mimetypes/small/22x22/application-x-egon.svg	pass	78856	39391	39465	0
svgs/oxygen-icons-5.113.0/scalable/mimetypes/small/22x22/application-x-executable-script.svg	pass	129027	47783	81244	0
svgs/oxygen-icons-5.113.0/scalable/mimetypes/small/22x22/application-x-executable.svg	pass	99924	43551	56373	0
svgs/oxygen-icons-5.113.0/scalable/mimetypes/small/22x22/application-x-font-afm.svg	pass	88707	13934	74773	1
svgs/oxygen-icons-5.113.0/scalable/mimetypes/small/22x22/application-x-font-bdf.svg	pass	23366	10424	12942	0
svgs/oxygen-icons-5.113.0/scalable/mimetypes/small/22x22/application-x-font-otf.svg	pass	62705	20980	41725	0
svgs/oxygen-icons-5.113.0/scalable/mimetypes/small/22x22/application-x-font-pcf.svg	pass	23366	10424	12942	0
svgs/oxygen-icons-5.113.0/scalable/mimetypes/small/22x22/application-x-font-snf.svg	pass	23366	10424	12942	0
svgs/oxygen-icons-5.113.0/scalable/mimetypes/small/22x22/application-x-font-ttf.svg	pass	23091	10376	12715	0
svgs/oxygen-icons-5.113.0/scalable/mimetypes/small/22x22/application-x-font-type1.svg	pass	88707	13934	74773	1
svgs/oxygen-icons-5.113.0/scalable/mimetypes/small/22x22/application-x-gnumeric.svg	pass	32369	12003	20366	0
svgs/oxygen-icons-5.113.0/scalable/mimetypes/small/22x22/application-x-gzdvi.svg	pass	191045	83110	107935	0
svgs/oxygen-icons-5.113.0/scalable/mimetypes/small/22x22/application-x-gzip.svg	pass	141309	57312	83997	0
svgs/oxygen-icons-5.113.0/scalable/mimetypes/small/22x22/application-x-gzpostscript.svg	pass	49270	22455	26815	1
svgs/oxygen-icons-5.113.0/scalable/mimetypes/small/22x22/application-x-it87.svg	pass	98119	32638	65481	0
svgs/oxygen-icons-5.113.0/scalable/mimetypes/small/22x22/application-x-java-applet.svg	pass	110975	34822	76153	0
svgs/oxygen-icons-5.113.0/scalable/mimetypes/small/22x22/application-x-java-archive.svg	pass	98328	23445	74883	0
svgs/oxygen-icons-5.113.0/scalable/mimetypes/small/22x22/application-x-java.svg	pass	62222	30652	31570	0
svgs/oxygen-icons-5.113.0/scalable/mimetypes/small/22x22/application-x-javascript.svg	mismatch	91934	37668	54266	13
svgs/oxygen-icons-5.113.0/scalable/mimetypes/small/22x22/application-x-k3b.svg	mismatch	892928	169550	723378	11
svgs/oxygen-icons-5.113.0/scalable/mimetypes/small/22x22/application-x-kcsrc.svg	pass	50229	22328	27901	0
svgs/oxygen-icons-5.113.0/scalable/mimetypes/small/22x22/application-x-kexi-connectiondata.svg	pass	194675	45101	149574	0
svgs/oxygen-icons-5.113.0/scalable/mimetypes/small/22x22/application-x-kexiproject-shortcut.svg	pass	202291	46049	156242	0
svgs/oxygen-icons-5.113.0/scalable/mimetypes/small/22x22/application-x-kexiproject-sqlite.svg	pass	124504	33225	91279	0
svgs/oxygen-icons-5.113.0/scalable/mimetypes/small/22x22/application-x-kexiproject-sqlite2.svg	pass	124504	33225	91279	0
svgs/oxygen-icons-5.113.0/scalable/mimetypes/small/22x22/application-x-kexiproject-sqlite3.svg	pass	124504	33225	91279	0
svgs/oxygen-icons-5.113.0/scalable/mimetypes/small/22x22/application-x-kformula.svg	pass	53329	13197	40132	0
svgs/oxygen-icons-5.113.0/scalable/mimetypes/small/22x22/application-x-kgetlist.svg	pass	45364	18624	26740	0
svgs/oxygen-icons-5.113.0/scalable/mimetypes/small/22x22/application-x-kontour.svg	pass	33785	15657	18128	0
svgs/oxygen-icons-5.113.0/scalable/mimetypes/small/22x22/application-x-kplato.svg	pass	31852	12141	19711	0
svgs/oxygen-icons-5.113.0/scalable/mimetypes/small/22x22/application-x-krita.svg	pass	126245	62780	63465	0
svgs/oxygen-icons-5.113.0/scalable/mimetypes/small/22x22/application-x-kword.svg	pass	289892	142395	147497	0
svgs/oxygen-icons-5.113.0/scalable/mimetypes/small/22x22/application-x-lha.svg	pass	193232	84233	108999	0
svgs/oxygen-icons-5.113.0/scalable/mimetypes/small/22x22/application-x-lyx.svg	pass	152709	40638	112071	0
svgs/oxygen-icons-5.113.0/scalable/mimetypes/small/22x22/application-x-lzma-compressed-tar.svg	pass	49266	20064	29202	0
svgs/oxygen-icons-5.113.0/scalable/mimetypes/small/22x22/application-x-lzop.svg	pass	141309	57312	83997	0
svgs/oxygen-icons-5.113.0/scalable/mimetypes/small/22x22/application-x-m4.svg	pass	118370	49517	68853	0
svgs/oxygen-icons-5.113.0/scalable/mimetypes/small/22x22/application-x-marble.svg	pass	434005	225505	208500	0
svgs/oxygen-icons-5.113.0/scalable/mimetypes/small/22x22/application-x-mimearchive.svg	pass	196372	36013	160359	0
svgs/oxygen-icons-5.113.0/scalable/mimetypes/small/22x22/application-x-mplayer2.svg	pass	51681	21132	30549	4
svgs/oxygen-icons-5.113.0/scalable/mimetypes/small/22x22/application-x-ms-dos-executable.svg	pass	123082	47232	75850	0
svgs/oxygen-icons-5.113.0/scalable/mimetypes/small/22x22/application-x-mswinurl.svg	pass	777410	364651	412759	0
svgs/oxygen-icons-5.113.0/scalable/mimetypes/small/22x22/application-x-mswrite.svg	pass	253064	128164	124900	0
svgs/oxygen-icons-5.113.0/scalable/mimetypes/small/22x22/application-x-nzb.svg	pass	50088	23458	26630	0
svgs/oxygen-icons-5.113.0/scalable/mimetypes/small/22x22/application-x-object.svg	pass	58550	16043	42507	0
svgs/oxygen-icons-5.113.0/scalable/mimetypes/small/22x22/application-x-pak.svg	pass	141309	57312	83997	0
svgs/oxygen-icons-5.113.0/scalable/mimetypes/small/22x22/application-x-pem-key.svg	pass	402630	77766	324864	2
svgs/oxygen-icons-5.113.0/scalable/mimetypes/small/22x22/application-x-perl.svg	pass	477449	262254	215195	0
svgs/oxygen-icons-5.113.0/scalable/mimetypes/small/22x22/application-x-php.svg	pass	53658	14926	38732	0
svgs/oxygen-icons-5.113.0/scalable/mimetypes/small/22x22/application-x-plasma.svg	pass	79624	27997	51627	0
svgs/oxygen-icons-5.113.0/scalable/mimetypes/small/22x22/application-x-python-bytecode.svg	pass	58550	16043	42507	0
svgs/oxygen-icons-5.113.0/scalable/mimetypes/small/22x22/application-x-qet-element.svg	pass	463032	118872	344160	0
svgs/oxygen-icons-5.113.0/scalable/mimetypes/small/22x22/application-x-qet-project.svg	pass	457067	118156	338911	0
svgs/oxygen-icons-5.113.0/scalable/mimetypes/small/22x22/application-x-quattropro.svg	pass	32369	12003	20366	0
svgs/oxygen-icons-5.113.0/scalable/mimetypes/small/22x22/application-x-rar.svg	pass	193232	84233	108999	0
svgs/oxygen-icons-5.113.0/scalable/mimetypes/small/22x22/application-x-rpm.svg	pass	56041	22861	33180	0
svgs/oxygen-icons-5.113.0/scalable/mimetypes/small/22x22/application-x-ruby.svg	pass	61915	26622	35293	0
svgs/oxygen-icons-5.113.0/scalable/mimetypes/small/22x22/application-x-sharedlib.svg	pass	58550	16043	42507	0
svgs/oxygen-icons-5.113.0/scalable/mimetypes/small/22x22/application-x-shellscript.svg	pass	38716	14021	24695	0
svgs/oxygen-icons-5.113.0/scalable/mimetypes/small/22x22/application-x-shockwave-flash.svg	pass	51681	21132	30549	4
svgs/oxygen-icons-5.113.0/scalable/mimetypes/small/22x22/application-x-siag.svg	pass	32369	12003	20366	0
svgs/oxygen-icons-5.113.0/scalable/mimetypes/small/22x22/application-x-sqlite2.svg	pass	124504	33225	91279	0
svgs/oxygen-icons-5.113.0/scalable/mimetypes/small/22x22/application-x-sqlite3.svg	pass	124504	33225	91279	0
svgs/oxygen-icons-5.113.0/scalable/mimetypes/small/22x22/application-x-srt.svg	mismatch	464116	306205	157911	9
svgs/oxygen-icons-5.113.0/scalable/mimetypes/small/22x22/application-x-srtrip.svg	mismatch	464494	305840	158654	9
svgs/oxygen-icons-5.113.0/scalable/mimetypes/small/22x22/application-x-subrip.svg	mismatch	464494	305840	158654	9
svgs/oxygen-icons-5.113.0/scalable/mimetypes/small/22x22/application-x-tar.svg	pass	49266	20064	29202	0
svgs/oxygen-icons-5.113.0/scalable/mimetypes/small/22x22/application-x-tarz.svg	pass	193232	84233	108999	0
svgs/oxygen-icons-5.113.0/scalable/mimetypes/small/22x22/application-x-tgif.svg	pass	33785	15657	18128	0
svgs/oxygen-icons-5.113.0/scalable/mimetypes/small/22x22/application-x-trash.svg	pass	45224	21374	23850	0
svgs/oxygen-icons-5.113.0/scalable/mimetypes/small/22x22/application-x-troff-man.svg	pass	47414	15105	32309	0
svgs/oxygen-icons-5.113.0/scalable/mimetypes/small/22x22/application-x-tzo.svg	pass	193232	84233	108999	0
svgs/oxygen-icons-5.113.0/scalable/mimetypes/small/22x22/application-x-wmf.svg	pass	33785	15657	18128	0
svgs/oxygen-icons-5.113.0/scalable/mimetypes/small/22x22/application-x-zerosize.svg	pass	17014	7630	9384	0
svgs/oxygen-icons-5.113.0/scalable/mimetypes/small/22x22/application-x-zip.svg	pass	154754	65185	89569	0
svgs/oxygen-icons-5.113.0/scalable/mimetypes/small/22x22/application-x-zoo.svg	pass	193232	84233	108999	0
svgs/oxygen-icons-5.113.0/scalable/mimetypes/small/22x22/application-xhtml+xml.svg	pass	106606	16821	89785	0
svgs/oxygen-icons-5.113.0/scalable/mimetypes/small/22x22/application-xml.svg	pass	39703	14232	25471	0
svgs/oxygen-icons-5.113.0/scalable/mimetypes/small/22x22/application-xsd.svg	pass	651372	278759	372613	1
svgs/oxygen-icons-5.113.0/scalable/mimetypes/small/22x22/application-xslt+xml.svg	pass	777410	364651	412759	0
svgs/oxygen-icons-5.113.0/scalable/mimetypes/small/22x22/application-zip.svg	pass	193232	84233	108999	0
svgs/oxygen-icons-5.113.0/scalable/mimetypes/small/22x22/audio-ac3.svg	pass	47898	16427	31471	0
svgs/oxygen-icons-5.113.0/scalable/mimetypes/small/22x22/audio-midi.svg	pass	272554	11196	261358	3
svgs/oxygen-icons-5.113.0/scalable/mimetypes/small/22x22/audio-prs.sid.svg	pass	272554	11196	261358	3
svgs/oxygen-icons-5.113.0/scalable/mimetypes/small/22x22/audio-vn.rn-realmedia.svg	pass	51681	21132	30549	4
svgs/oxygen-icons-5.113.0/scalable/mimetypes/small/22x22/audio-vnd.rn-realvideo.svg	pass	51681	21132	30549	4
svgs/oxygen-icons-5.113.0/scalable/mimetypes/small/22x22/audio-x-adpcm.svg	pass	47898	16427	31471	0
svgs/oxygen-icons-5.113.0/scalable/mimetypes/small/22x22/audio-x-aiff.svg	pass	47898	16427	31471	0
svgs/oxygen-icons-5.113.0/scalable/mimetypes/small/22x22/audio-x-flac+ogg.svg	pass	47898	16427	31471	0
svgs/oxygen-icons-5.113.0/scalable/mimetypes/small/22x22/audio-x-flac.svg	pass	47898	16427	31471	0
svgs/oxygen-icons-5.113.0/scalable/mimetypes/small/22x22/audio-x-generic.svg	pass	47898	16427	31471	0
svgs/oxygen-icons-5.113.0/scalable/mimetypes/small/22x22/audio-x-monkey.svg	pass	47898	16427	31471	0
svgs/oxygen-icons-5.113.0/scalable/mimetypes/small/22x22/audio-x-speex+ogg.svg	pass	130701	61359	69342	0
svgs/oxygen-icons-5.113.0/scalable/mimetypes/small/22x22/encrypted.svg	pass	410509	78763	331746	0
svgs/oxygen-icons-5.113.0/scalable/mimetypes/small/22x22/image-svg+xml-compressed.svg	pass	33785	15657	18128	0
svgs/oxygen-icons-5.113.0/scalable/mimetypes/small/22x22/image-svg+xml.svg	pass	33785	15657	18128	0
svgs/oxygen-icons-5.113.0/scalable/mimetypes/small/22x22/image-vnd.dgn.svg	pass	495031	130299	364732	0
svgs/oxygen-icons-5.113.0/scalable/mimetypes/small/22x22/image-vnd.dwg.svg	pass	75108	21198	53910	0
svgs/oxygen-icons-5.113.0/scalable/mimetypes/small/22x22/image-x-adobe-dng.svg	pass	79681	39914	39767	0
svgs/oxygen-icons-5.113.0/scalable/mimetypes/small/22x22/image-x-eps.svg	pass	33467	15489	17978	0
svgs/oxygen-icons-5.113.0/scalable/mimetypes/small/22x22/image-x-generic.svg	pass	78856	39391	39465	0
svgs/oxygen-icons-5.113.0/scalable/mimetypes/small/22x22/image-x-vnd.trolltech.qpicture.svg	pass	40683	15790	24893	0
svgs/oxygen-icons-5.113.0/scalable/mimetypes/small/22x22/image-x-xfig.svg	pass	33785	15657	18128	0
svgs/oxygen-icons-5.113.0/scalable/mimetypes/small/22x22/inode-directory.svg	pass	129849	116894	12955	0
svgs/oxygen-icons-5.113.0/scalable/mimetypes/small/22x22/mail-message-new-list.svg	pass	196372	36013	160359	0
svgs/oxygen-icons-5.113.0/scalable/mimetypes/small/22x22/message-news.svg	pass	145284	8521	136763	0
svgs/oxygen-icons-5.113.0/scalable/mimetypes/small/22x22/message-partial.svg	pass	196466	36771	159695	0
svgs/oxygen-icons-5.113.0/scalable/mimetypes/small/22x22/message-rfc822.svg	pass	196372	36013	160359	0
svgs/oxygen-icons-5.113.0/scalable/mimetypes/small/22x22/message-x-gnu-rmail.svg	pass	196372	36013	160359	0
svgs/oxygen-icons-5.113.0/scalable/mimetypes/small/22x22/message.svg	pass	196372	36013	160359	0
svgs/oxygen-icons-5.113.0/scalable/mimetypes/small/22x22/package-x-generic.svg	pass	49266	20064	29202	0
svgs/oxygen-icons-5.113.0/scalable/mimetypes/small/22x22/text-adasrc.svg	pass	35670	10867	24803	0
svgs/oxygen-icons-5.113.0/scalable/mimetypes/small/22x22/text-calendar.svg	pass	52138	14029	38109	0
svgs/oxygen-icons-5.113.0/scalable/mimetypes/small/22x22/text-csharp.svg	mismatch	54696	19313	35383	5
svgs/oxygen-icons-5.113.0/scalable/mimetypes/small/22x22/text-css.svg	mismatch	464116	306205	157911	9
svgs/oxygen-icons-5.113.0/scalable/mimetypes/small/22x22/text-csv.svg	pass	32369	12003	20366	0
svgs/oxygen-icons-5.113.0/scalable/mimetypes/small/22x22/text-directory.svg	pass	115969	47036	68933	0
svgs/oxygen-icons-5.113.0/scalable/mimetypes/small/22x22/text-enriched.svg	pass	189377	118347	71030	0
svgs/oxygen-icons-5.113.0/scalable/mimetypes/small/22x22/text-html.svg	pass	777410	364651	412759	0
svgs/oxygen-icons-5.113.0/scalable/mimetypes/small/22x22/text-mathml.svg	pass	45748	11999	33749	0
svgs/oxygen-icons-5.113.0/scalable/mimetypes/small/22x22/text-plain.svg	mismatch	464111	306205	157906	9
svgs/oxygen-icons-5.113.0/scalable/mimetypes/small/22x22/text-rdf+xml.svg	pass	31856	10740	21116	0
svgs/oxygen-icons-5.113.0/scalable/mimetypes/small/22x22/text-rdf.svg	pass	31856	10740	21116	0
svgs/oxygen-icons-5.113.0/scalable/mimetypes/small/22x22/text-rtf.svg	pass	270018	142232	127786	0
svgs/oxygen-icons-5.113.0/scalable/mimetypes/small/22x22/text-sgml.svg	pass	189377	118347	71030	0
svgs/oxygen-icons-5.113.0/scalable/mimetypes/small/22x22/text-troff.svg	pass	309612	94760	214852	0
svgs/oxygen-icons-5.113.0/scalable/mimetypes/small/22x22/text-vcalendar.svg	pass	52138	14029	38109	0
svgs/oxygen-icons-5.113.0/scalable/mimetypes/small/22x22/text-vnd.abc.svg	pass	47898	16427	31471	0
svgs/oxygen-icons-5.113.0/scalable/mimetypes/small/22x22/text-vnd.wap.wml.svg	pass	999177	395903	603274	0
svgs/oxygen-icons-5.113.0/scalable/mimetypes/small/22x22/text-x-authors.svg	pass	189377	118347	71030	0
svgs/oxygen-icons-5.113.0/scalable/mimetypes/small/22x22/text-x-bibtex.svg	pass	20313	9665	10648	0
svgs/oxygen-icons-5.113.0/scalable/mimetypes/small/22x22/text-x-c++hdr.svg	pass	36950	14111	22839	0
svgs/oxygen-icons-5.113.0/scalable/mimetypes/small/22x22/text-x-c++src.svg	pass	48948	16482	32466	0
svgs/oxygen-icons-5.113.0/scalable/mimetypes/small/22x22/text-x-changelog.svg	mismatch	464494	305840	158654	9
svgs/oxygen-icons-5.113.0/scalable/mimetypes/small/22x22/text-x-chdr.svg	mismatch	34560	14067	20493	9
svgs/oxygen-icons-5.113.0/scalable/mimetypes/small/22x22/text-x-cmake.svg	pass	189377	118347	71030	0
svgs/oxygen-icons-5.113.0/scalable/mimetypes/small/22x22/text-x-copying.svg	pass	189377	118347	71030	0
svgs/oxygen-icons-5.113.0/scalable/mimetypes/small/22x22/text-x-csharp.svg	mismatch	54696	19313	35383	5
svgs/oxygen-icons-5.113.0/scalable/mimetypes/small/22x22/text-x-csrc.svg	pass	75408	16180	59228	0
svgs/oxygen-icons-5.113.0/scalable/mimetypes/small/22x22/text-x-dtd.svg	pass	999177	395903	603274	0
svgs/oxygen-icons-5.113.0/scalable/mimetypes/small/22x22/text-x-generic.svg	pass	189377	118347	71030	0
svgs/oxygen-icons-5.113.0/scalable/mimetypes/small/22x22/text-x-haskell.svg	pass	32210	11251	20959	0
svgs/oxygen-icons-5.113.0/scalable/mimetypes/small/22x22/text-x-hex.svg	pass	30336	11542	18794	1
svgs/oxygen-icons-5.113.0/scalable/mimetypes/small/22x22/text-x-install.svg	pass	189377	118347	71030	0
svgs/oxygen-icons-5.113.0/scalable/mimetypes/small/22x22/text-x-java.svg	pass	110975	34822	76153	0
svgs/oxygen-icons-5.113.0/scalable/mimetypes/small/22x22/text-x-katefilelist.svg	pass	410106	134347	275759	0
svgs/oxygen-icons-5.113.0/scalable/mimetypes/small/22x22/text-x-ldif.svg	pass	115447	46603	68844	0
svgs/oxygen-icons-5.113.0/scalable/mimetypes/small/22x22/text-x-lilypond.svg	pass	34908	15285	19623	0
svgs/oxygen-icons-5.113.0/scalable/mimetypes/small/22x22/text-x-log.svg	pass	189377	118347	71030	0
svgs/oxygen-icons-5.113.0/scalable/mimetypes/small/22x22/text-x-makefile.svg	pass	243052	90263	152789	2
svgs/oxygen-icons-5.113.0/scalable/mimetypes/small/22x22/text-x-nfo.svg	pass	189377	118347	71030	0
svgs/oxygen-icons-5.113.0/scalable/mimetypes/small/22x22/text-x-objchdr.svg	mismatch	34560	14067	20493	9
svgs/oxygen-icons-5.113.0/scalable/mimetypes/small/22x22/text-x-objcsrc.svg	pass	75408	16180	59228	0
svgs/oxygen-icons-5.113.0/scalable/mimetypes/small/22x22/text-x-pascal.svg	pass	1337176	1042680	294496	0
svgs/oxygen-icons-5.113.0/scalable/mimetypes/small/22x22/text-x-patch.svg	pass	131140	33138	98002	0
svgs/oxygen-icons-5.113.0/scalable/mimetypes/small/22x22/text-x-po.svg	pass	171953	113278	58675	0
svgs/oxygen-icons-5.113.0/scalable/mimetypes/small/22x22/text-x-python.svg	pass	47882	19880	28002	0
svgs/oxygen-icons-5.113.0/scalable/mimetypes/small/22x22/text-x-qml.svg	pass	44562	20427	24135	0
svgs/oxygen-icons-5.113.0/scalable/mimetypes/small/22x22/text-x-readme.svg	pass	189377	118347	71030	0
svgs/oxygen-icons-5.113.0/scalable/mimetypes/small/22x22/text-x-rpm-spec.svg	pass	31444	11799	19645	0
svgs/oxygen-icons-5.113.0/scalable/mimetypes/small/22x22/text-x-script.svg	pass	38707	14021	24686	0
svgs/oxygen-icons-5.113.0/scalable/mimetypes/small/22x22/text-x-sql.svg	pass	93018	36704	56314	0
svgs/oxygen-icons-5.113.0/scalable/mimetypes/small/22x22/text-x-tcl.svg	pass	24074	9122	14952	0
svgs/oxygen-icons-5.113.0/scalable/mimetypes/small/22x22/text-x-tex.svg	pass	20313	9665	10648	0
svgs/oxygen-icons-5.113.0/scalable/mimetypes/small/22x22/text-x-texinfo.svg	pass	75400	16180	59220	0
svgs/oxygen-icons-5.113.0/scalable/mimetypes/small/22x22/text-x-vcard.svg	pass	115447	46603	68844	0
svgs/oxygen-icons-5.113.0/scalable/mimetypes/small/22x22/text-x-xslfo.svg	pass	999177	395903	603274	0
svgs/oxygen-icons-5.113.0/scalable/mimetypes/small/22x22/text-xmcd.svg	pass	68808	31410	37398	0
svgs/oxygen-icons-5.113.0/scalable/mimetypes/small/22x22/text-xml.svg	pass	106594	16821	89773	0
svgs/oxygen-icons-5.113.0/scalable/mimetypes/small/22x22/unknown.svg	pass	47761	20829	26932	0
svgs/oxygen-icons-5.113.0/scalable/mimetypes/small/22x22/uri-mms.svg	pass	51681	21132	30549	4
svgs/oxygen-icons-5.113.0/scalable/mimetypes/small/22x22/uri-mmst.svg	pass	51681	21132	30549	4
svgs/oxygen-icons-5.113.0/scalable/mimetypes/small/22x22/uri-mmsu.svg	pass	51681	21132	30549	4
svgs/oxygen-icons-5.113.0/scalable/mimetypes/small/22x22/uri-pnm.svg	pass	51681	21132	30549	4
svgs/oxygen-icons-5.113.0/scalable/mimetypes/small/22x22/uri-rtspt.svg	pass	51681	21132	30549	4
svgs/oxygen-icons-5.113.0/scalable/mimetypes/small/22x22/uri-rtspu.svg	pass	51681	21132	30549	4
svgs/oxygen-icons-5.113.0/scalable/mimetypes/small/22x22/video-x-generic.svg	pass	51681	21132	30549	4
svgs/oxygen-icons-5.113.0/scalable/mimetypes/small/22x22/video-x-mng.svg	pass	78856	39391	39465	0
svgs/oxygen-icons-5.113.0/scalable/mimetypes/small/22x22/x-kde-nsplugin-generated.svg	pass	48291	20865	27426	3
svgs/oxygen-icons-5.113.0/scalable/mimetypes/small/22x22/x-media-podcast.svg	pass	76708	33556	43152	0
svgs/oxygen-icons-5.113.0/scalable/mimetypes/small/22x22/x-office-address-book.svg	pass	2985125	2323852	661273	0
svgs/oxygen-icons-5.113.0/scalable/mimetypes/small/22x22/x-office-calendar.svg	pass	52138	14029	38109	0
svgs/oxygen-icons-5.113.0/scalable/mimetypes/small/22x22/x-office-contact.svg	pass	101682	46364	55318	0
svgs/oxygen-icons-5.113.0/scalable/mimetypes/small/22x22/x-office-document.svg	pass	18413	8476	9937	0
svgs/oxygen-icons-5.113.0/scalable/mimetypes/small/22x22/x-office-presentation.svg	pass	103645	14697	88948	0
svgs/oxygen-icons-5.113.0/scalable/mimetypes/small/22x22/x-office-spreadsheet.svg	pass	32369	12003	20366	0
svgs/oxygen-icons-5.113.0/scalable/mimetypes/small/32x32/application-epub+zip.svg	pass	2781876	2319051	462825	0
svgs/oxygen-icons-5.113.0/scalable/mimetypes/small/32x32/application-illustrator.svg	pass	25291	12388	12903	0
svgs/oxygen-icons-5.113.0/scalable/mimetypes/small/32x32/application-javascript.svg	pass	62460	24401	38059	0
svgs/oxygen-icons-5.113.0/scalable/mimetypes/small/32x32/application-msword-template.svg	pass	350296	204098	146198	3
svgs/oxygen-icons-5.113.0/scalable/mimetypes/small/32x32/application-msword.svg	pass	351657	204013	147644	2
svgs/oxygen-icons-5.113.0/scalable/mimetypes/small/32x32/application-octet-stream.svg	pass	46897	14790	32107	0
svgs/oxygen-icons-5.113.0/scalable/mimetypes/small/32x32/application-pdf.svg	pass	21126	10280	10846	0
svgs/oxygen-icons-5.113.0/scalable/mimetypes/small/32x32/application-pgp-encrypted.svg	pass	201532	18046	183486	0
svgs/oxygen-icons-5.113.0/scalable/mimetypes/small/32x32/application-pgp-keys.svg	pass	427766	78047	349719	0
svgs/oxygen-icons-5.113.0/scalable/mimetypes/small/32x32/application-pkcs7-mime.svg	pass	427766	78047	349719	0
svgs/oxygen-icons-5.113.0/scalable/mimetypes/small/32x32/application-postscript.svg	pass	61333	28932	32401	0
svgs/oxygen-icons-5.113.0/scalable/mimetypes/small/32x32/application-relaxng.svg	pass	991686	395650	596036	1
svgs/oxygen-icons-5.113.0/scalable/mimetypes/small/32x32/application-rtf.svg	pass	162337	127579	34758	0
svgs/oxygen-icons-5.113.0/scalable/mimetypes/small/32x32/application-sxw.svg	pass	224724	160525	64199	0
svgs/oxygen-icons-5.113.0/scalable/mimetypes/small/32x32/application-vnd-google-earth-kml.svg	pass	22175	10217	11958	0
svgs/oxygen-icons-5.113.0/scalable/mimetypes/small/32x32/application-vnd.iccprofile.svg	pass	72513	32037	40476	1
svgs/oxygen-icons-5.113.0/scalable/mimetypes/small/32x32/application-vnd.ms-access.svg	pass	94214	38534	55680	0
svgs/oxygen-icons-5.113.0/scalable/mimetypes/small/32x32/application-vnd.ms-excel.svg	pass	42713	18053	24660	0
svgs/oxygen-icons-5.113.0/scalable/mimetypes/small/32x32/application-vnd.ms-powerpoint.svg	pass	53314	19830	33484	0
svgs/oxygen-icons-5.113.0/scalable/mimetypes/small/32x32/application-vnd.oasis.opendocument.chart.svg	pass	81058	30522	50536	0
svgs/oxygen-icons-5.113.0/scalable/mimetypes/small/32x32/application-vnd.oasis.opendocument.database.svg	pass	91377	37194	54183	0
svgs/oxygen-icons-5.113.0/scalable/mimetypes/small/32x32/application-vnd.oasis.opendocument.formula-template.svg	pass	69648	26136	43512	0
svgs/oxygen-icons-5.113.0/scalable/mimetypes/small/32x32/application-vnd.oasis.opendocument.formula.svg	pass	66476	26675	39801	0
svgs/oxygen-icons-5.113.0/scalable/mimetypes/small/32x32/application-vnd.oasis.opendocument.graphics.svg	pass	60076	21779	38297	0
svgs/oxygen-icons-5.113.0/scalable/mimetypes/small/32x32/application-vnd.oasis.opendocument.image.svg	pass	177135	84685	92450	0
svgs/oxygen-icons-5.113.0/scalable/mimetypes/small/32x32/application-vnd.oasis.opendocument.presentation-template.svg	pass	50070	18278	31792	0
svgs/oxygen-icons-5.113.0/scalable/mimetypes/small/32x32/application-vnd.oasis.opendocument.presentation.svg	pass	50238	18189	32049	0
svgs/oxygen-icons-5.113.0/scalable/mimetypes/small/32x32/application-vnd.oasis.opendocument.spreadsheet-template.svg	pass	44783	17047	27736	0
svgs/oxygen-icons-5.113.0/scalable/mimetypes/small/32x32/application-vnd.oasis.opendocument.spreadsheet.svg	pass	40482	16972	23510	0
svgs/oxygen-icons-5.113.0/scalable/mimetypes/small/32x32/application-vnd.oasis.opendocument.text-template.svg	pass	348676	202813	145863	3
svgs/oxygen-icons-5.113.0/scalable/mimetypes/small/32x32/application-vnd.oasis.opendocument.text.svg	pass	346498	202771	143727	1
svgs/oxygen-icons-5.113.0/scalable/mimetypes/small/32x32/application-vnd.openxmlformats-officedocument.wordprocessingml.document.svg	pass	346498	202771	143727	1
svgs/oxygen-icons-5.113.0/scalable/mimetypes/small/32x32/application-vnd.rn-realmedia.svg	pass	53050	21333	31717	0
svgs/oxygen-icons-5.113.0/scalable/mimetypes/small/32x32/application-vnd.scribus.svg	pass	57718	23099	34619	0
svgs/oxygen-icons-5.113.0/scalable/mimetypes/small/32x32/application-vnd.stardivision.calc.svg	pass	40482	16972	23510	0
svgs/oxygen-icons-5.113.0/scalable/mimetypes/small/32x32/application-vnd.stardivision.draw.svg	pass	177135	84685	92450	0
svgs/oxygen-icons-5.113.0/scalable/mimetypes/small/32x32/application-vnd.stardivision.mail.svg	pass	109126	57203	51923	0
svgs/oxygen-icons-5.113.0/scalable/mimetypes/small/32x32/application-vnd.stardivision.math.svg	pass	66476	26675	39801	0
svgs/oxygen-icons-5.113.0/scalable/mimetypes/small/32x32/application-vnd.sun.xml.calc.svg	pass	40482	16972	23510	0
svgs/oxygen-icons-5.113.0/scalable/mimetypes/small/32x32/application-vnd.sun.xml.calc.template.svg	pass	44783	17047	27736	0
svgs/oxygen-icons-5.113.0/scalable/mimetypes/small/32x32/application-vnd.sun.xml.draw.svg	pass	177135	84685	92450	0
svgs/oxygen-icons-5.113.0/scalable/mimetypes/small/32x32/application-vnd.sun.xml.draw.template.svg	pass	181367	84747	96620	0
svgs/oxygen-icons-5.113.0/scalable/mimetypes/small/32x32/application-vnd.sun.xml.math.svg	pass	66476	26675	39801	0
svgs/oxygen-icons-5.113.0/scalable/mimetypes/small/32x32/application-vnd.wordperfect.svg	pass	350693	203458	147235	2
svgs/oxygen-icons-5.113.0/scalable/mimetypes/small/32x32/application-x-7z-compressed.svg	pass	162937	68796	94141	1
svgs/oxygen-icons-5.113.0/scalable/mimetypes/small/32x32/application-x-abiword.svg	pass	346498	202771	143727	1
svgs/oxygen-icons-5.113.0/scalable/mimetypes/small/32x32/application-x-ace.svg	pass	162937	68796	94141	1
svgs/oxygen-icons-5.113.0/scalable/mimetypes/small/32x32/application-x-applix-spreadsheet.svg	pass	40482	16972	23510	0
svgs/oxygen-icons-5.113.0/scalable/mimetypes/small/32x32/application-x-applix-word.svg	pass	336538	196507	140031	4
svgs/oxygen-icons-5.113.0/scalable/mimetypes/small/32x32/application-x-ar.svg	pass	40454	19485	20969	0
svgs/oxygen-icons-5.113.0/scalable/mimetypes/small/32x32/application-x-arc.svg	pass	162937	68796	94141	1
svgs/oxygen-icons-5.113.0/scalable/mimetypes/small/32x32/application-x-archive.svg	pass	40454	19485	20969	0
svgs/oxygen-icons-5.113.0/scalable/mimetypes/small/32x32/application-x-arj.svg	pass	162937	68796	94141	1
svgs/oxygen-icons-5.113.0/scalable/mimetypes/small/32x32/application-x-bittorrent.svg	pass	215136	119355	95781	0
svgs/oxygen-icons-5.113.0/scalable/mimetypes/small/32x32/application-x-blender.svg	pass	39747	20661	19086	0
svgs/oxygen-icons-5.113.0/scalable/mimetypes/small/32x32/application-x-bzdvi.svg	pass	160706	67644	93062	1
svgs/oxygen-icons-5.113.0/scalable/mimetypes/small/32x32/application-x-bzip-compressed-tar.svg	pass	162937	68796	94141	1
svgs/oxygen-icons-5.113.0/scalable/mimetypes/small/32x32/application-x-bzip.svg	pass	241810	62499	179311	0
svgs/oxygen-icons-5.113.0/scalable/mimetypes/small/32x32/application-x-cd-image.svg	pass	47124	21911	25213	0
svgs/oxygen-icons-5.113.0/scalable/mimetypes/small/32x32/application-x-cda.svg	pass	75159	35137	40022	0
svgs/oxygen-icons-5.113.0/scalable/mimetypes/small/32x32/application-x-chm.svg	pass	21073	10053	11020	0
svgs/oxygen-icons-5.113.0/scalable/mimetypes/small/32x32/application-x-compress.svg	pass	241810	62499	179311	0
svgs/oxygen-icons-5.113.0/scalable/mimetypes/small/32x32/application-x-compressed-tar.svg	pass	44899	21386	23513	1
svgs/oxygen-icons-5.113.0/scalable/mimetypes/small/32x32/application-x-cpio.svg	pass	40454	19485	20969	0
svgs/oxygen-icons-5.113.0/scalable/mimetypes/small/32x32/application-x-cue.svg	pass	287476	141035	146441	0
svgs/oxygen-icons-5.113.0/scalable/mimetypes/small/32x32/application-x-deb.svg	pass	46818	22112	24706	2
svgs/oxygen-icons-5.113.0/scalable/mimetypes/small/32x32/application-x-designer.svg	pass	102434	40313	62121	0
svgs/oxygen-icons-5.113.0/scalable/mimetypes/small/32x32/application-x-desktop.svg	pass	99851	43484	56367	2
svgs/oxygen-icons-5.113.0/scalable/mimetypes/small/32x32/application-x-egon.svg	pass	78262	39002	39260	0
svgs/oxygen-icons-5.113.0/scalable/mimetypes/small/32x32/application-x-executable-script.svg	pass	107585	47029	60556	0
svgs/oxygen-icons-5.113.0/scalable/mimetypes/small/32x32/application-x-executable.svg	pass	99851	43484	56367	2
svgs/oxygen-icons-5.113.0/scalable/mimetypes/small/32x32/application-x-font-afm.svg	pass	32811	17239	15572	0
svgs/oxygen-icons-5.113.0/scalable/mimetypes/small/32x32/application-x-font-bdf.svg	pass	36499	20677	15822	0
svgs/oxygen-icons-5.113.0/scalable/mimetypes/small/32x32/application-x-font-otf.svg	pass	48326	20475	27851	0
svgs/oxygen-icons-5.113.0/scalable/mimetypes/small/32x32/application-x-font-pcf.svg	pass	36499	20677	15822	0
svgs/oxygen-icons-5.113.0/scalable/mimetypes/small/32x32/application-x-font-snf.svg	pass	36499	20677	15822	0
svgs/oxygen-icons-5.113.0/scalable/mimetypes/small/32x32/application-x-font-ttf.svg	pass	45734	19898	25836	0
svgs/oxygen-icons-5.113.0/scalable/mimetypes/small/32x32/application-x-font-type1.svg	pass	32811	17239	15572	0
svgs/oxygen-icons-5.113.0/scalable/mimetypes/small/32x32/application-x-gnumeric.svg	pass	40482	16972	23510	0
svgs/oxygen-icons-5.113.0/scalable/mimetypes/small/32x32/application-x-gzdvi.svg	pass	160706	67644	93062	1
svgs/oxygen-icons-5.113.0/scalable/mimetypes/small/32x32/application-x-gzip.svg	pass	241810	62499	179311	0
svgs/oxygen-icons-5.113.0/scalable/mimetypes/small/32x32/application-x-gzpostscript.svg	pass	354489	79484	275005	1
svgs/oxygen-icons-5.113.0/scalable/mimetypes/small/32x32/application-x-it87.svg	pass	72513	32037	40476	1
svgs/oxygen-icons-5.113.0/scalable/mimetypes/small/32x32/application-x-java-applet.svg	pass	2781103	1429441	1351662	0
svgs/oxygen-icons-5.113.0/scalable/mimetypes/small/32x32/application-x-java-archive.svg	pass	45867	21764	24103	1
svgs/oxygen-icons-5.113.0/scalable/mimetypes/small/32x32/application-x-java.svg	pass	61848	30478	31370	0
svgs/oxygen-icons-5.113.0/scalable/mimetypes/small/32x32/application-x-javascript.svg	pass	62460	24401	38059	0
svgs/oxygen-icons-5.113.0/scalable/mimetypes/small/32x32/application-x-k3b.svg	mismatch	576721	169618	407103	6
svgs/oxygen-icons-5.113.0/scalable/mimetypes/small/32x32/application-x-kcsrc.svg	pass	58841	22171	36670	0
svgs/oxygen-icons-5.113.0/scalable/mimetypes/small/32x32/application-x-kexi-connectiondata.svg	pass	135285	49348	85937	0
svgs/oxygen-icons-5.113.0/scalable/mimetypes/small/32x32/application-x-kexiproject-shortcut.svg	pass	135902	50361	85541	0
svgs/oxygen-icons-5.113.0/scalable/mimetypes/small/32x32/application-x-kformula.svg	pass	66476	26675	39801	0
svgs/oxygen-icons-5.113.0/scalable/mimetypes/small/32x32/application-x-kgetlist.svg	pass	37974	18245	19729	0
svgs/oxygen-icons-5.113.0/scalable/mimetypes/small/32x32/application-x-kontour.svg	pass	33485	15573	17912	0
svgs/oxygen-icons-5.113.0/scalable/mimetypes/small/32x32/application-x-kplato.svg	pass	46557	18704	27853	0
svgs/oxygen-icons-5.113.0/scalable/mimetypes/small/32x32/application-x-krita.svg	pass	115807	62829	52978	0
svgs/oxygen-icons-5.113.0/scalable/mimetypes/small/32x32/application-x-kword.svg	pass	346498	202771	143727	1
svgs/oxygen-icons-5.113.0/scalable/mimetypes/small/32x32/application-x-lha.svg	pass	162937	68796	94141	1
svgs/oxygen-icons-5.113.0/scalable/mimetypes/small/32x32/application-x-lyx.svg	pass	344021	199262	144759	4
svgs/oxygen-icons-5.113.0/scalable/mimetypes/small/32x32/application-x-lzma-compressed-tar.svg	pass	40454	19485	20969	0
svgs/oxygen-icons-5.113.0/scalable/mimetypes/small/32x32/application-x-lzop.svg	pass	241810	62499	179311	0
svgs/oxygen-icons-5.113.0/scalable/mimetypes/small/32x32/application-x-m4.svg	pass	102954	48596	54358	0
svgs/oxygen-icons-5.113.0/scalable/mimetypes/small/32x32/application-x-marble.svg	pass	433640	225354	208286	0
svgs/oxygen-icons-5.113.0/scalable/mimetypes/small/32x32/application-x-mimearchive.svg	pass	109104	57203	51901	0
svgs/oxygen-icons-5.113.0/scalable/mimetypes/small/32x32/application-x-mplayer2.svg	pass	53050	21333	31717	0
svgs/oxygen-icons-5.113.0/scalable/mimetypes/small/32x32/application-x-ms-dos-executable.svg	pass	106728	46669	60059	0
svgs/oxygen-icons-5.113.0/scalable/mimetypes/small/32x32/application-x-mswinurl.svg	pass	778000	364521	413479	0
svgs/oxygen-icons-5.113.0/scalable/mimetypes/small/32x32/application-x-mswrite.svg	pass	343720	188749	154971	1
svgs/oxygen-icons-5.113.0/scalable/mimetypes/small/32x32/application-x-nzb.svg	pass	32866	16857	16009	0
svgs/oxygen-icons-5.113.0/scalable/mimetypes/small/32x32/application-x-object.svg	pass	46897	14790	32107	0
svgs/oxygen-icons-5.113.0/scalable/mimetypes/small/32x32/application-x-pak.svg	pass	241810	62499	179311	0
svgs/oxygen-icons-5.113.0/scalable/mimetypes/small/32x32/application-x-pem-key.svg	pass	427766	78047	349719	0
svgs/oxygen-icons-5.113.0/scalable/mimetypes/small/32x32/application-x-perl.svg	pass	442600	259863	182737	1
svgs/oxygen-icons-5.113.0/scalable/mimetypes/small/32x32/application-x-php.svg	pass	40455	15485	24970	0
svgs/oxygen-icons-5.113.0/scalable/mimetypes/small/32x32/application-x-plasma.svg	pass	62107	27316	34791	0
svgs/oxygen-icons-5.113.0/scalable/mimetypes/small/32x32/application-x-python-bytecode.svg	pass	46897	14790	32107	0
svgs/oxygen-icons-5.113.0/scalable/mimetypes/small/32x32/application-x-qet-element.svg	pass	40280	15066	25214	0
svgs/oxygen-icons-5.113.0/scalable/mimetypes/small/32x32/application-x-qet-project.svg	pass	18833	8852	9981	0
svgs/oxygen-icons-5.113.0/scalable/mimetypes/small/32x32/application-x-quattropro.svg	pass	40482	16972	23510	0
svgs/oxygen-icons-5.113.0/scalable/mimetypes/small/32x32/application-x-rar.svg	pass	162937	68796	94141	1
svgs/oxygen-icons-5.113.0/scalable/mimetypes/small/32x32/application-x-rpm.svg	pass	47229	22275	24954	0
svgs/oxygen-icons-5.113.0/scalable/mimetypes/small/32x32/application-x-ruby.svg	pass	187670	74742	112928	0
svgs/oxygen-icons-5.113.0/scalable/mimetypes/small/32x32/application-x-sharedlib.svg	pass	46897	14790	32107	0
svgs/oxygen-icons-5.113.0/scalable/mimetypes/small/32x32/application-x-shellscript.svg	pass	25061	11141	13920	0
svgs/oxygen-icons-5.113.0/scalable/mimetypes/small/32x32/application-x-shockwave-flash.svg	pass	53094	21399	31695	0
svgs/oxygen-icons-5.113.0/scalable/mimetypes/small/32x32/application-x-siag.svg	pass	40482	16972	23510	0
svgs/oxygen-icons-5.113.0/scalable/mimetypes/small/32x32/application-x-srt.svg	pass	635258	253035	382223	4
svgs/oxygen-icons-5.113.0/scalable/mimetypes/small/32x32/application-x-srtrip.svg	pass	635258	253035	382223	4
svgs/oxygen-icons-5.113.0/scalable/mimetypes/small/32x32/application-x-subrip.svg	pass	636940	253487	383453	1
svgs/oxygen-icons-5.113.0/scalable/mimetypes/small/32x32/application-x-tar.svg	pass	40454	19485	20969	0
svgs/oxygen-icons-5.113.0/scalable/mimetypes/small/32x32/application-x-tarz.svg	pass	162937	68796	94141	1
svgs/oxygen-icons-5.113.0/scalable/mimetypes/small/32x32/application-x-tgif.svg	pass	33485	15573	17912	0
svgs/oxygen-icons-5.113.0/scalable/mimetypes/small/32x32/application-x-trash.svg	pass	30267	14548	15719	0
svgs/oxygen-icons-5.113.0/scalable/mimetypes/small/32x32/application-x-troff-man.svg	pass	40834	14599	26235	0
svgs/oxygen-icons-5.113.0/scalable/mimetypes/small/32x32/application-x-tzo.svg	pass	162937	68796	94141	1
svgs/oxygen-icons-5.113.0/scalable/mimetypes/small/32x32/application-x-wmf.svg	pass	33485	15573	17912	0
svgs/oxygen-icons-5.113.0/scalable/mimetypes/small/32x32/application-x-zerosize.svg	pass	16659	7478	9181	0
svgs/oxygen-icons-5.113.0/scalable/mimetypes/small/32x32/application-x-zoo.svg	pass	162937	68796	94141	1
svgs/oxygen-icons-5.113.0/scalable/mimetypes/small/32x32/application-xhtml+xml.svg	pass	805213	371478	433735	0
svgs/oxygen-icons-5.113.0/scalable/mimetypes/small/32x32/application-xml.svg	pass	39461	14232	25229	0
svgs/oxygen-icons-5.113.0/scalable/mimetypes/small/32x32/application-xsd.svg	pass	646788	272286	374502	1
svgs/oxygen-icons-5.113.0/scalable/mimetypes/small/32x32/application-xslt+xml.svg	pass	778000	364521	413479	0
svgs/oxygen-icons-5.113.0/scalable/mimetypes/small/32x32/application-zip.svg	pass	162937	68796	94141	1
svgs/oxygen-icons-5.113.0/scalable/mimetypes/small/32x32/audio-ac3.svg	pass	111863	43931	67932	0
svgs/oxygen-icons-5.113.0/scalable/mimetypes/small/32x32/audio-midi.svg	pass	274584	36328	238256	0
svgs/oxygen-icons-5.113.0/scalable/mimetypes/small/32x32/audio-prs.sid.svg	pass	274584	36328	238256	0
svgs/oxygen-icons-5.113.0/scalable/mimetypes/small/32x32/audio-vn.rn-realmedia.svg	pass	53050	21333	31717	0
svgs/oxygen-icons-5.113.0/scalable/mimetypes/small/32x32/audio-vnd.rn-realvideo.svg	pass	53050	21333	31717	0
svgs/oxygen-icons-5.113.0/scalable/mimetypes/small/32x32/audio-x-adpcm.svg	pass	57483	30375	27108	0
svgs/oxygen-icons-5.113.0/scalable/mimetypes/small/32x32/audio-x-aiff.svg	pass	57483	30375	27108	0
svgs/oxygen-icons-5.113.0/scalable/mimetypes/small/32x32/audio-x-flac+ogg.svg	pass	111863	43931	67932	0
svgs/oxygen-icons-5.113.0/scalable/mimetypes/small/32x32/audio-x-flac.svg	pass	111863	43931	67932	0
svgs/oxygen-icons-5.113.0/scalable/mimetypes/small/32x32/audio-x-generic.svg	pass	111863	43931	67932	0
svgs/oxygen-icons-5.113.0/scalable/mimetypes/small/32x32/audio-x-monkey.svg	pass	111863	43931	67932	0
svgs/oxygen-icons-5.113.0/scalable/mimetypes/small/32x32/audio-x-speex+ogg.svg	pass	144987	75427	69560	1
svgs/oxygen-icons-5.113.0/scalable/mimetypes/small/32x32/audio-x-wav.svg	pass	57483	30375	27108	0
svgs/oxygen-icons-5.113.0/scalable/mimetypes/small/32x32/encrypted.svg	pass	428297	78280	350017	0
svgs/oxygen-icons-5.113.0/scalable/mimetypes/small/32x32/image-svg+xml-compressed.svg	pass	791140	71151	719989	1
svgs/oxygen-icons-5.113.0/scalable/mimetypes/small/32x32/image-svg+xml.svg	pass	33485	15573	17912	0
svgs/oxygen-icons-5.113.0/scalable/mimetypes/small/32x32/image-vnd.dgn.svg	pass	44319	13660	30659	0
svgs/oxygen-icons-5.113.0/scalable/mimetypes/small/32x32/image-vnd.dwg.svg	pass	25437	12438	12999	0
svgs/oxygen-icons-5.113.0/scalable/mimetypes/small/32x32/image-x-adobe-dng.svg	pass	79795	39883	39912	0
svgs/oxygen-icons-5.113.0/scalable/mimetypes/small/32x32/image-x-eps.svg	pass	42209	15695	26514	0
svgs/oxygen-icons-5.113.0/scalable/mimetypes/small/32x32/image-x-generic.svg	pass	78262	39002	39260	0
svgs/oxygen-icons-5.113.0/scalable/mimetypes/small/32x32/image-x-vnd.trolltech.qpicture.svg	pass	41719	15704	26015	0
svgs/oxygen-icons-5.113.0/scalable/mimetypes/small/32x32/image-x-xfig.svg	pass	33485	15573	17912	0
svgs/oxygen-icons-5.113.0/scalable/mimetypes/small/32x32/inode-directory.svg	pass	133192	119980	13212	0
svgs/oxygen-icons-5.113.0/scalable/mimetypes/small/32x32/message-news.svg	pass	147870	9907	137963	0
svgs/oxygen-icons-5.113.0/scalable/mimetypes/small/32x32/message-partial.svg	pass	111755	58249	53506	0
svgs/oxygen-icons-5.113.0/scalable/mimetypes/small/32x32/message-rfc822.svg	pass	109104	57203	51901	0
svgs/oxygen-icons-5.113.0/scalable/mimetypes/small/32x32/message-x-gnu-rmail.svg	pass	109104	57203	51901	0
svgs/oxygen-icons-5.113.0/scalable/mimetypes/small/32x32/message.svg	pass	109104	57203	51901	0
svgs/oxygen-icons-5.113.0/scalable/mimetypes/small/32x32/package-x-generic.svg	pass	40454	19485	20969	0
svgs/oxygen-icons-5.113.0/scalable/mimetypes/small/32x32/text-calendar.svg	pass	86517	36551	49966	0
svgs/oxygen-icons-5.113.0/scalable/mimetypes/small/32x32/text-css.svg	pass	592871	235691	357180	1
svgs/oxygen-icons-5.113.0/scalable/mimetypes/small/32x32/text-csv.svg	pass	43480	18784	24696	0
svgs/oxygen-icons-5.113.0/scalable/mimetypes/small/32x32/text-directory.svg	pass	111130	46454	64676	0
svgs/oxygen-icons-5.113.0/scalable/mimetypes/small/32x32/text-enriched.svg	pass	162337	127579	34758	0
svgs/oxygen-icons-5.113.0/scalable/mimetypes/small/32x32/text-html.svg	pass	778000	364521	413479	0
svgs/oxygen-icons-5.113.0/scalable/mimetypes/small/32x32/text-mathml.svg	pass	56857	20463	36394	0
svgs/oxygen-icons-5.113.0/scalable/mimetypes/small/32x32/text-plain.svg	pass	594932	236560	358372	1
svgs/oxygen-icons-5.113.0/scalable/mimetypes/small/32x32/text-rdf+xml.svg	pass	23467	10238	13229	0
svgs/oxygen-icons-5.113.0/scalable/mimetypes/small/32x32/text-rdf.svg	pass	23467	10238	13229	0
svgs/oxygen-icons-5.113.0/scalable/mimetypes/small/32x32/text-rtf.svg	pass	336538	196507	140031	4
svgs/oxygen-icons-5.113.0/scalable/mimetypes/small/32x32/text-sgml.svg	pass	152988	123546	29442	0
svgs/oxygen-icons-5.113.0/scalable/mimetypes/small/32x32/text-troff.svg	pass	562108	173581	388527	0
svgs/oxygen-icons-5.113.0/scalable/mimetypes/small/32x32/text-vcalendar.svg	pass	86517	36551	49966	0
svgs/oxygen-icons-5.113.0/scalable/mimetypes/small/32x32/text-vnd.abc.svg	pass	111863	43931	67932	0
svgs/oxygen-icons-5.113.0/scalable/mimetypes/small/32x32/text-vnd.wap.wml.svg	pass	991686	395650	596036	1
svgs/oxygen-icons-5.113.0/scalable/mimetypes/small/32x32/text-x-authors.svg	pass	170245	131433	38812	0
svgs/oxygen-icons-5.113.0/scalable/mimetypes/small/32x32/text-x-bibtex.svg	pass	25209	12998	12211	0
svgs/oxygen-icons-5.113.0/scalable/mimetypes/small/32x32/text-x-c++hdr.svg	pass	60521	24551	35970	0
svgs/oxygen-icons-5.113.0/scalable/mimetypes/small/32x32/text-x-c++src.svg	pass	73376	24864	48512	0
svgs/oxygen-icons-5.113.0/scalable/mimetypes/small/32x32/text-x-changelog.svg	pass	594932	236560	358372	1
svgs/oxygen-icons-5.113.0/scalable/mimetypes/small/32x32/text-x-chdr.svg	pass	62043	20684	41359	1
svgs/oxygen-icons-5.113.0/scalable/mimetypes/small/32x32/text-x-cmake.svg	pass	221657	161529	60128	0
svgs/oxygen-icons-5.113.0/scalable/mimetypes/small/32x32/text-x-copying.svg	pass	176184	135128	41056	0
svgs/oxygen-icons-5.113.0/scalable/mimetypes/small/32x32/text-x-csharp.svg	pass	76283	29686	46597	0
svgs/oxygen-icons-5.113.0/scalable/mimetypes/small/32x32/text-x-csrc.svg	pass	41342	20536	20806	0
svgs/oxygen-icons-5.113.0/scalable/mimetypes/small/32x32/text-x-dtd.svg	pass	991686	395650	596036	1
svgs/oxygen-icons-5.113.0/scalable/mimetypes/small/32x32/text-x-generic.svg	pass	152988	123546	29442	0
svgs/oxygen-icons-5.113.0/scalable/mimetypes/small/32x32/text-x-haskell.svg	pass	181100	97852	83248	0
svgs/oxygen-icons-5.113.0/scalable/mimetypes/small/32x32/text-x-hex.svg	pass	23505	11018	12487	3
svgs/oxygen-icons-5.113.0/scalable/mimetypes/small/32x32/text-x-install.svg	pass	212244	144414	67830	0
svgs/oxygen-icons-5.113.0/scalable/mimetypes/small/32x32/text-x-java.svg	pass	381243	109789	271454	0
svgs/oxygen-icons-5.113.0/scalable/mimetypes/small/32x32/text-x-katefilelist.svg	mismatch	185014	139583	45431	5
svgs/oxygen-icons-5.113.0/scalable/mimetypes/small/32x32/text-x-ldif.svg	pass	89838	46331	43507	0
svgs/oxygen-icons-5.113.0/scalable/mimetypes/small/32x32/text-x-lilypond.svg	pass	218980	15314	203666	0
svgs/oxygen-icons-5.113.0/scalable/mimetypes/small/32x32/text-x-log.svg	pass	156118	124857	31261	0
svgs/oxygen-icons-5.113.0/scalable/mimetypes/small/32x32/text-x-makefile.svg	pass	249164	94870	154294	2
svgs/oxygen-icons-5.113.0/scalable/mimetypes/small/32x32/text-x-nfo.svg	pass	152988	123546	29442	0
svgs/oxygen-icons-5.113.0/scalable/mimetypes/small/32x32/text-x-objchdr.svg	pass	62043	20684	41359	1
svgs/oxygen-icons-5.113.0/scalable/mimetypes/small/32x32/text-x-objcsrc.svg	pass	41342	20536	20806	0
svgs/oxygen-icons-5.113.0/scalable/mimetypes/small/32x32/text-x-pascal.svg	pass	1336549	1044927	291622	0
svgs/oxygen-icons-5.113.0/scalable/mimetypes/small/32x32/text-x-patch.svg	pass	123572	32020	91552	0
svgs/oxygen-icons-5.113.0/scalable/mimetypes/small/32x32/text-x-po.svg	pass	165038	112779	52259	0
svgs/oxygen-icons-5.113.0/scalable/mimetypes/small/32x32/text-x-python.svg	pass	56156	34205	21951	0
svgs/oxygen-icons-5.113.0/scalable/mimetypes/small/32x32/text-x-qml.svg	pass	38129	19930	18199	0
svgs/oxygen-icons-5.113.0/scalable/mimetypes/small/32x32/text-x-readme.svg	pass	577318	336415	240903	0
svgs/oxygen-icons-5.113.0/scalable/mimetypes/small/32x32/text-x-rpm-spec.svg	pass	24509	11278	13231	0
svgs/oxygen-icons-5.113.0/scalable/mimetypes/small/32x32/text-x-script.svg	pass	25061	11141	13920	0
svgs/oxygen-icons-5.113.0/scalable/mimetypes/small/32x32/text-x-sql.svg	pass	83887	36079	47808	0
svgs/oxygen-icons-5.113.0/scalable/mimetypes/small/32x32/text-x-tex.svg	pass	25209	12998	12211	0
svgs/oxygen-icons-5.113.0/scalable/mimetypes/small/32x32/text-x-texinfo.svg	pass	33879	16066	17813	0
svgs/oxygen-icons-5.113.0/scalable/mimetypes/small/32x32/text-x-vcard.svg	pass	89838	46331	43507	0
svgs/oxygen-icons-5.113.0/scalable/mimetypes/small/32x32/text-x-xslfo.svg	pass	991686	395650	596036	1
svgs/oxygen-icons-5.113.0/scalable/mimetypes/small/32x32/text-xmcd.svg	pass	75159	35137	40022	0
svgs/oxygen-icons-5.113.0/scalable/mimetypes/small/32x32/text-xml.svg	pass	39700	14232	25468	0
svgs/oxygen-icons-5.113.0/scalable/mimetypes/small/32x32/unknown.svg	pass	33410	17038	16372	0
svgs/oxygen-icons-5.113.0/scalable/mimetypes/small/32x32/uri-mms.svg	pass	2751822	1420207	1331615	0
svgs/oxygen-icons-5.113.0/scalable/mimetypes/small/32x32/uri-mmst.svg	pass	2751822	1420207	1331615	0
svgs/oxygen-icons-5.113.0/scalable/mimetypes/small/32x32/uri-mmsu.svg	pass	2751822	1420207	1331615	0
svgs/oxygen-icons-5.113.0/scalable/mimetypes/small/32x32/uri-pnm.svg	pass	2751822	1420207	1331615	0
svgs/oxygen-icons-5.113.0/scalable/mimetypes/small/32x32/uri-rtspt.svg	pass	2751822	1420207	1331615	0
svgs/oxygen-icons-5.113.0/scalable/mimetypes/small/32x32/uri-rtspu.svg	pass	2751822	1420207	1331615	0
svgs/oxygen-icons-5.113.0/scalable/mimetypes/small/32x32/video-x-generic.svg	pass	53050	21333	31717	0
svgs/oxygen-icons-5.113.0/scalable/mimetypes/small/32x32/video-x-mng.svg	pass	78262	39002	39260	0
svgs/oxygen-icons-5.113.0/scalable/mimetypes/small/32x32/x-kde-nsplugin-generated.svg	pass	37918	20355	17563	0
svgs/oxygen-icons-5.113.0/scalable/mimetypes/small/32x32/x-media-podcast.svg	pass	76346	33404	42942	0
svgs/oxygen-icons-5.113.0/scalable/mimetypes/small/32x32/x-office-address-book.svg	pass	2981996	2323868	658128	0
svgs/oxygen-icons-5.113.0/scalable/mimetypes/small/32x32/x-office-calendar.svg	pass	86517	36551	49966	0
svgs/oxygen-icons-5.113.0/scalable/mimetypes/small/32x32/x-office-document.svg	pass	38683	13690	24993	0
svgs/oxygen-icons-5.113.0/scalable/mimetypes/small/32x32/x-office-presentation.svg	pass	50238	18189	32049	0
svgs/oxygen-icons-5.113.0/scalable/mimetypes/small/32x32/x-office-spreadsheet.svg	pass	40482	16972	23510	0
svgs/oxygen-icons-5.113.0/scalable/mimetypes/small/48x48/application-epub+zip.svg	pass	2779759	2318018	461741	0
svgs/oxygen-icons-5.113.0/scalable/mimetypes/small/48x48/application-illustrator.svg	pass	22772	11206	11566	0
svgs/oxygen-icons-5.113.0/scalable/mimetypes/small/48x48/application-javascript.svg	pass	42240	20989	21251	0
svgs/oxygen-icons-5.113.0/scalable/mimetypes/small/48x48/application-msword-template.svg	pass	791525	409799	381726	0
svgs/oxygen-icons-5.113.0/scalable/mimetypes/small/48x48/application-msword.svg	pass	788632	410409	378223	0
svgs/oxygen-icons-5.113.0/scalable/mimetypes/small/48x48/application-octet-stream.svg	pass	112065	51366	60699	0
svgs/oxygen-icons-5.113.0/scalable/mimetypes/small/48x48/application-pdf.svg	pass	91881	9902	81979	0
svgs/oxygen-icons-5.113.0/scalable/mimetypes/small/48x48/application-pgp-encrypted.svg	pass	180842	18359	162483	0
svgs/oxygen-icons-5.113.0/scalable/mimetypes/small/48x48/application-pgp-keys.svg	pass	406011	77706	328305	0
svgs/oxygen-icons-5.113.0/scalable/mimetypes/small/48x48/application-pkcs7-mime.svg	pass	406011	77706	328305	0
svgs/oxygen-icons-5.113.0/scalable/mimetypes/small/48x48/application-postscript.svg	pass	133067	28261	104806	0
svgs/oxygen-icons-5.113.0/scalable/mimetypes/small/48x48/application-relaxng.svg	pass	502846	200972	301874	0
svgs/oxygen-icons-5.113.0/scalable/mimetypes/small/48x48/application-rtf.svg	pass	191038	127140	63898	0
svgs/oxygen-icons-5.113.0/scalable/mimetypes/small/48x48/application-sxw.svg	pass	253514	160158	93356	0
svgs/oxygen-icons-5.113.0/scalable/mimetypes/small/48x48/application-vnd-google-earth-kml.svg	pass	97615	10140	87475	0
svgs/oxygen-icons-5.113.0/scalable/mimetypes/small/48x48/application-vnd.iccprofile.svg	pass	72493	31652	40841	0
svgs/oxygen-icons-5.113.0/scalable/mimetypes/small/48x48/application-vnd.ms-access.svg	pass	166954	39187	127767	0
svgs/oxygen-icons-5.113.0/scalable/mimetypes/small/48x48/application-vnd.ms-excel.svg	pass	72308	20893	51415	0
svgs/oxygen-icons-5.113.0/scalable/mimetypes/small/48x48/application-vnd.ms-powerpoint.svg	pass	131222	23218	108004	0
svgs/oxygen-icons-5.113.0/scalable/mimetypes/small/48x48/application-vnd.oasis.opendocument.chart.svg	pass	81733	30676	51057	1
svgs/oxygen-icons-5.113.0/scalable/mimetypes/small/48x48/application-vnd.oasis.opendocument.database.svg	pass	236380	63262	173118	0
svgs/oxygen-icons-5.113.0/scalable/mimetypes/small/48x48/application-vnd.oasis.opendocument.formula-template.svg	pass	71601	26520	45081	0
svgs/oxygen-icons-5.113.0/scalable/mimetypes/small/48x48/application-vnd.oasis.opendocument.formula.svg	pass	69068	27093	41975	0
svgs/oxygen-icons-5.113.0/scalable/mimetypes/small/48x48/application-vnd.oasis.opendocument.graphics.svg	pass	86888	22082	64806	0
svgs/oxygen-icons-5.113.0/scalable/mimetypes/small/48x48/application-vnd.oasis.opendocument.image.svg	pass	240423	85058	155365	0
svgs/oxygen-icons-5.113.0/scalable/mimetypes/small/48x48/application-vnd.oasis.opendocument.presentation-template.svg	pass	156055	20971	135084	0
svgs/oxygen-icons-5.113.0/scalable/mimetypes/small/48x48/application-vnd.oasis.opendocument.presentation.svg	pass	128218	21494	106724	0
svgs/oxygen-icons-5.113.0/scalable/mimetypes/small/48x48/application-vnd.oasis.opendocument.spreadsheet-template.svg	pass	43446	19234	24212	0
svgs/oxygen-icons-5.113.0/scalable/mimetypes/small/48x48/application-vnd.oasis.opendocument.spreadsheet.svg	pass	67958	18859	49099	0
svgs/oxygen-icons-5.113.0/scalable/mimetypes/small/48x48/application-vnd.oasis.opendocument.text.svg	pass	891726	472005	419721	0
svgs/oxygen-icons-5.113.0/scalable/mimetypes/small/48x48/application-vnd.openxmlformats-officedocument.wordprocessingml.document.svg	pass	891726	472005	419721	0
svgs/oxygen-icons-5.113.0/scalable/mimetypes/small/48x48/application-vnd.rn-realmedia.svg	pass	89625	33633	55992	0
svgs/oxygen-icons-5.113.0/scalable/mimetypes/small/48x48/application-vnd.scribus.svg	pass	128460	24566	103894	0
svgs/oxygen-icons-5.113.0/scalable/mimetypes/small/48x48/application-vnd.stardivision.calc.svg	pass	67958	18859	49099	0
svgs/oxygen-icons-5.113.0/scalable/mimetypes/small/48x48/application-vnd.stardivision.draw.svg	pass	240423	85058	155365	0
svgs/oxygen-icons-5.113.0/scalable/mimetypes/small/48x48/application-vnd.stardivision.mail.svg	pass	244355	136514	107841	1
svgs/oxygen-icons-5.113.0/scalable/mimetypes/small/48x48/application-vnd.stardivision.math.svg	pass	69068	27093	41975	0
svgs/oxygen-icons-5.113.0/scalable/mimetypes/small/48x48/application-vnd.sun.xml.calc.svg	pass	67958	18859	49099	0
svgs/oxygen-icons-5.113.0/scalable/mimetypes/small/48x48/application-vnd.sun.xml.calc.template.svg	pass	66252	19234	47018	0
svgs/oxygen-icons-5.113.0/scalable/mimetypes/small/48x48/application-vnd.sun.xml.draw.svg	pass	240423	85058	155365	0
svgs/oxygen-icons-5.113.0/scalable/mimetypes/small/48x48/application-vnd.sun.xml.draw.template.svg	pass	243412	84483	158929	0
svgs/oxygen-icons-5.113.0/scalable/mimetypes/small/48x48/application-vnd.sun.xml.math.svg	pass	69068	27093	41975	0
svgs/oxygen-icons-5.113.0/scalable/mimetypes/small/48x48/application-vnd.sun.xml.writer.template.svg	pass	790426	408512	381914	0
svgs/oxygen-icons-5.113.0/scalable/mimetypes/small/48x48/application-vnd.wordperfect.svg	pass	787845	409987	377858	0
svgs/oxygen-icons-5.113.0/scalable/mimetypes/small/48x48/application-x-7z-compressed.svg	pass	266776	101439	165337	0
svgs/oxygen-icons-5.113.0/scalable/mimetypes/small/48x48/application-x-abiword.svg	pass	891726	472005	419721	0
svgs/oxygen-icons-5.113.0/scalable/mimetypes/small/48x48/application-x-ace.svg	pass	266776	101439	165337	0
svgs/oxygen-icons-5.113.0/scalable/mimetypes/small/48x48/application-x-applix-spreadsheet.svg	pass	67958	18859	49099	0
svgs/oxygen-icons-5.113.0/scalable/mimetypes/small/48x48/application-x-applix-word.svg	pass	875720	465086	410634	0
svgs/oxygen-icons-5.113.0/scalable/mimetypes/small/48x48/application-x-ar.svg	pass	72870	35885	36985	0
svgs/oxygen-icons-5.113.0/scalable/mimetypes/small/48x48/application-x-arc.svg	pass	266776	101439	165337	0
svgs/oxygen-icons-5.113.0/scalable/mimetypes/small/48x48/application-x-archive.svg	pass	72870	35885	36985	0
svgs/oxygen-icons-5.113.0/scalable/mimetypes/small/48x48/application-x-arj.svg	pass	266776	101439	165337	0
svgs/oxygen-icons-5.113.0/scalable/mimetypes/small/48x48/application-x-bittorrent.svg	pass	351898	137572	214326	0
svgs/oxygen-icons-5.113.0/scalable/mimetypes/small/48x48/application-x-blender.svg	pass	47942	26056	21886	0
svgs/oxygen-icons-5.113.0/scalable/mimetypes/small/48x48/application-x-bzdvi.svg	pass	265285	100486	164799	0
svgs/oxygen-icons-5.113.0/scalable/mimetypes/small/48x48/application-x-bzip-compressed-tar.svg	pass	266776	101439	165337	0
svgs/oxygen-icons-5.113.0/scalable/mimetypes/small/48x48/application-x-bzip.svg	pass	257195	93914	163281	0
svgs/oxygen-icons-5.113.0/scalable/mimetypes/small/48x48/application-x-cd-image.svg	pass	104141	44452	59689	0
svgs/oxygen-icons-5.113.0/scalable/mimetypes/small/48x48/application-x-cda.svg	pass	126876	54418	72458	0
svgs/oxygen-icons-5.113.0/scalable/mimetypes/small/48x48/application-x-chm.svg	pass	24315	12558	11757	0
svgs/oxygen-icons-5.113.0/scalable/mimetypes/small/48x48/application-x-compress.svg	pass	257195	93914	163281	0
svgs/oxygen-icons-5.113.0/scalable/mimetypes/small/48x48/application-x-compressed-tar.svg	pass	83574	39834	43740	0
svgs/oxygen-icons-5.113.0/scalable/mimetypes/small/48x48/application-x-cpio.svg	pass	72870	35885	36985	0
svgs/oxygen-icons-5.113.0/scalable/mimetypes/small/48x48/application-x-cue.svg	pass	341761	162298	179463	0
svgs/oxygen-icons-5.113.0/scalable/mimetypes/small/48x48/application-x-deb.svg	pass	86990	41291	45699	3
svgs/oxygen-icons-5.113.0/scalable/mimetypes/small/48x48/application-x-designer.svg	pass	175434	56632	118802	0
svgs/oxygen-icons-5.113.0/scalable/mimetypes/small/48x48/application-x-desktop.svg	pass	99500	43303	56197	0
svgs/oxygen-icons-5.113.0/scalable/mimetypes/small/48x48/application-x-egon.svg	pass	192221	153724	38497	0
svgs/oxygen-icons-5.113.0/scalable/mimetypes/small/48x48/application-x-executable-script.svg	pass	108145	46450	61695	0
svgs/oxygen-icons-5.113.0/scalable/mimetypes/small/48x48/application-x-executable.svg	pass	99500	43303	56197	0
svgs/oxygen-icons-5.113.0/scalable/mimetypes/small/48x48/application-x-font-afm.svg	pass	32878	18218	14660	0
svgs/oxygen-icons-5.113.0/scalable/mimetypes/small/48x48/application-x-font-bdf.svg	pass	113991	20212	93779	0
svgs/oxygen-icons-5.113.0/scalable/mimetypes/small/48x48/application-x-font-otf.svg	pass	47521	20468	27053	0
svgs/oxygen-icons-5.113.0/scalable/mimetypes/small/48x48/application-x-font-pcf.svg	pass	113991	20212	93779	0
svgs/oxygen-icons-5.113.0/scalable/mimetypes/small/48x48/application-x-font-snf.svg	pass	113991	20212	93779	0
svgs/oxygen-icons-5.113.0/scalable/mimetypes/small/48x48/application-x-font-ttf.svg	pass	118266	20325	97941	0
svgs/oxygen-icons-5.113.0/scalable/mimetypes/small/48x48/application-x-font-type1.svg	pass	32878	18218	14660	0
svgs/oxygen-icons-5.113.0/scalable/mimetypes/small/48x48/application-x-gnumeric.svg	pass	67958	18859	49099	0
svgs/oxygen-icons-5.113.0/scalable/mimetypes/small/48x48/application-x-gzdvi.svg	pass	265285	100486	164799	0
svgs/oxygen-icons-5.113.0/scalable/mimetypes/small/48x48/application-x-gzip.svg	pass	257195	93914	163281	0
svgs/oxygen-icons-5.113.0/scalable/mimetypes/small/48x48/application-x-gzpostscript.svg	pass	301807	115386	186421	0
svgs/oxygen-icons-5.113.0/scalable/mimetypes/small/48x48/application-x-it87.svg	pass	72493	31652	40841	0
svgs/oxygen-icons-5.113.0/scalable/mimetypes/small/48x48/application-x-java-applet.svg	pass	1470406	793106	677300	0
svgs/oxygen-icons-5.113.0/scalable/mimetypes/small/48x48/application-x-java-archive.svg	pass	81191	38801	42390	1
svgs/oxygen-icons-5.113.0/scalable/mimetypes/small/48x48/application-x-java.svg	pass	174573	46549	128024	0
svgs/oxygen-icons-5.113.0/scalable/mimetypes/small/48x48/application-x-javascript.svg	pass	42240	20989	21251	0
svgs/oxygen-icons-5.113.0/scalable/mimetypes/small/48x48/application-x-k3b.svg	mismatch	574861	170390	404471	138
svgs/oxygen-icons-5.113.0/scalable/mimetypes/small/48x48/application-x-kcsrc.svg	pass	190363	51852	138511	0
svgs/oxygen-icons-5.113.0/scalable/mimetypes/small/48x48/application-x-kexi-connectiondata.svg	pass	275857	75081	200776	0
svgs/oxygen-icons-5.113.0/scalable/mimetypes/small/48x48/application-x-kexiproject-shortcut.svg	pass	276617	76088	200529	0
svgs/oxygen-icons-5.113.0/scalable/mimetypes/small/48x48/application-x-kformula.svg	pass	69068	27093	41975	0
svgs/oxygen-icons-5.113.0/scalable/mimetypes/small/48x48/application-x-kgetlist.svg	pass	77397	33025	44372	0
svgs/oxygen-icons-5.113.0/scalable/mimetypes/small/48x48/application-x-kontour.svg	pass	32347	15193	17154	0
svgs/oxygen-icons-5.113.0/scalable/mimetypes/small/48x48/application-x-kplato.svg	pass	68155	18942	49213	0
svgs/oxygen-icons-5.113.0/scalable/mimetypes/small/48x48/application-x-krita.svg	pass	98982	62301	36681	0
svgs/oxygen-icons-5.113.0/scalable/mimetypes/small/48x48/application-x-kword.svg	pass	891726	472005	419721	0
svgs/oxygen-icons-5.113.0/scalable/mimetypes/small/48x48/application-x-lha.svg	pass	266776	101439	165337	0
svgs/oxygen-icons-5.113.0/scalable/mimetypes/small/48x48/application-x-lyx.svg	pass	890499	470597	419902	0
svgs/oxygen-icons-5.113.0/scalable/mimetypes/small/48x48/application-x-lzma-compressed-tar.svg	pass	72870	35885	36985	0
svgs/oxygen-icons-5.113.0/scalable/mimetypes/small/48x48/application-x-lzop.svg	pass	257195	93914	163281	0
svgs/oxygen-icons-5.113.0/scalable/mimetypes/small/48x48/application-x-m4.svg	pass	207864	76602	131262	0
svgs/oxygen-icons-5.113.0/scalable/mimetypes/small/48x48/application-x-marble.svg	pass	464017	224836	239181	0
svgs/oxygen-icons-5.113.0/scalable/mimetypes/small/48x48/application-x-mimearchive.svg	pass	244355	136514	107841	1
svgs/oxygen-icons-5.113.0/scalable/mimetypes/small/48x48/application-x-mplayer2.svg	pass	89625	33633	55992	0
svgs/oxygen-icons-5.113.0/scalable/mimetypes/small/48x48/application-x-ms-dos-executable.svg	pass	114002	47283	66719	0
svgs/oxygen-icons-5.113.0/scalable/mimetypes/small/48x48/application-x-mswinurl.svg	pass	2386718	1124927	1261791	0
svgs/oxygen-icons-5.113.0/scalable/mimetypes/small/48x48/application-x-mswrite.svg	pass	892024	457972	434052	0
svgs/oxygen-icons-5.113.0/scalable/mimetypes/small/48x48/application-x-nzb.svg	pass	33997	17279	16718	0
svgs/oxygen-icons-5.113.0/scalable/mimetypes/small/48x48/application-x-object.svg	pass	112065	51366	60699	0
svgs/oxygen-icons-5.113.0/scalable/mimetypes/small/48x48/application-x-pak.svg	pass	257195	93914	163281	0
svgs/oxygen-icons-5.113.0/scalable/mimetypes/small/48x48/application-x-pem-key.svg	pass	406011	77706	328305	0
svgs/oxygen-icons-5.113.0/scalable/mimetypes/small/48x48/application-x-perl.svg	pass	438353	261089	177264	0
svgs/oxygen-icons-5.113.0/scalable/mimetypes/small/48x48/application-x-php.svg	pass	33069	15369	17700	0
svgs/oxygen-icons-5.113.0/scalable/mimetypes/small/48x48/application-x-plasma.svg	pass	152020	71340	80680	0
svgs/oxygen-icons-5.113.0/scalable/mimetypes/small/48x48/application-x-python-bytecode.svg	pass	112065	51366	60699	0
svgs/oxygen-icons-5.113.0/scalable/mimetypes/small/48x48/application-x-qet-element.svg	pass	40308	16521	23787	0
svgs/oxygen-icons-5.113.0/scalable/mimetypes/small/48x48/application-x-qet-project.svg	pass	126386	59163	67223	0
svgs/oxygen-icons-5.113.0/scalable/mimetypes/small/48x48/application-x-quattropro.svg	pass	67958	18859	49099	0
svgs/oxygen-icons-5.113.0/scalable/mimetypes/small/48x48/application-x-rar.svg	pass	266776	101439	165337	0
svgs/oxygen-icons-5.113.0/scalable/mimetypes/small/48x48/application-x-rpm.svg	pass	87147	41774	45373	1
svgs/oxygen-icons-5.113.0/scalable/mimetypes/small/48x48/application-x-ruby.svg	pass	255259	70759	184500	0
svgs/oxygen-icons-5.113.0/scalable/mimetypes/small/48x48/application-x-sharedlib.svg	pass	112065	51366	60699	0
svgs/oxygen-icons-5.113.0/scalable/mimetypes/small/48x48/application-x-shellscript.svg	pass	78175	13976	64199	0
svgs/oxygen-icons-5.113.0/scalable/mimetypes/small/48x48/application-x-shockwave-flash.svg	pass	89704	33699	56005	0
svgs/oxygen-icons-5.113.0/scalable/mimetypes/small/48x48/application-x-siag.svg	pass	67958	18859	49099	0
svgs/oxygen-icons-5.113.0/scalable/mimetypes/small/48x48/application-x-srt.svg	pass	449832	210119	239713	0
svgs/oxygen-icons-5.113.0/scalable/mimetypes/small/48x48/application-x-subrip.svg	pass	450807	210587	240220	0
svgs/oxygen-icons-5.113.0/scalable/mimetypes/small/48x48/application-x-tar.svg	pass	72870	35885	36985	0
svgs/oxygen-icons-5.113.0/scalable/mimetypes/small/48x48/application-x-tarz.svg	pass	266776	101439	165337	0
svgs/oxygen-icons-5.113.0/scalable/mimetypes/small/48x48/application-x-tgif.svg	pass	32347	15193	17154	0
svgs/oxygen-icons-5.113.0/scalable/mimetypes/small/48x48/application-x-trash.svg	pass	30750	15457	15293	0
svgs/oxygen-icons-5.113.0/scalable/mimetypes/small/48x48/application-x-troff-man.svg	pass	40125	14074	26051	0
svgs/oxygen-icons-5.113.0/scalable/mimetypes/small/48x48/application-x-tzo.svg	pass	266776	101439	165337	0
svgs/oxygen-icons-5.113.0/scalable/mimetypes/small/48x48/application-x-wmf.svg	pass	32347	15193	17154	0
svgs/oxygen-icons-5.113.0/scalable/mimetypes/small/48x48/application-x-zerosize.svg	pass	87375	7106	80269	0
svgs/oxygen-icons-5.113.0/scalable/mimetypes/small/48x48/application-x-zoo.svg	pass	266776	101439	165337	0
svgs/oxygen-icons-5.113.0/scalable/mimetypes/small/48x48/application-xhtml+xml.svg	pass	2089578	1129757	959821	0
svgs/oxygen-icons-5.113.0/scalable/mimetypes/small/48x48/application-xml.svg	pass	42851	19555	23296	0
svgs/oxygen-icons-5.113.0/scalable/mimetypes/small/48x48/application-xsd.svg	pass	1989798	850081	1139717	0
svgs/oxygen-icons-5.113.0/scalable/mimetypes/small/48x48/application-xslt+xml.svg	pass	2386752	1124929	1261823	0
svgs/oxygen-icons-5.113.0/scalable/mimetypes/small/48x48/application-zip.svg	pass	266776	101439	165337	0
svgs/oxygen-icons-5.113.0/scalable/mimetypes/small/48x48/audio-ac3.svg	pass	118649	48431	70218	0
svgs/oxygen-icons-5.113.0/scalable/mimetypes/small/48x48/audio-midi.svg	pass	174847	45879	128968	0
svgs/oxygen-icons-5.113.0/scalable/mimetypes/small/48x48/audio-prs.sid.svg	pass	174847	45879	128968	0
svgs/oxygen-icons-5.113.0/scalable/mimetypes/small/48x48/audio-vn.rn-realmedia.svg	pass	89625	33633	55992	0
svgs/oxygen-icons-5.113.0/scalable/mimetypes/small/48x48/audio-vnd.rn-realvideo.svg	pass	89625	33633	55992	0
svgs/oxygen-icons-5.113.0/scalable/mimetypes/small/48x48/audio-x-adpcm.svg	pass	77553	43301	34252	0
svgs/oxygen-icons-5.113.0/scalable/mimetypes/small/48x48/audio-x-aiff.svg	pass	55852	29821	26031	0
svgs/oxygen-icons-5.113.0/scalable/mimetypes/small/48x48/audio-x-flac+ogg.svg	pass	118635	48428	70207	0
svgs/oxygen-icons-5.113.0/scalable/mimetypes/small/48x48/audio-x-flac.svg	pass	118635	48428	70207	0
svgs/oxygen-icons-5.113.0/scalable/mimetypes/small/48x48/audio-x-generic.svg	pass	118635	48428	70207	0
svgs/oxygen-icons-5.113.0/scalable/mimetypes/small/48x48/audio-x-monkey.svg	pass	118635	48428	70207	0
svgs/oxygen-icons-5.113.0/scalable/mimetypes/small/48x48/audio-x-speex+ogg.svg	pass	143727	75056	68671	0
svgs/oxygen-icons-5.113.0/scalable/mimetypes/small/48x48/audio-x-wav.svg	pass	55852	29821	26031	0
svgs/oxygen-icons-5.113.0/scalable/mimetypes/small/48x48/encrypted.svg	pass	407815	78313	329502	0
svgs/oxygen-icons-5.113.0/scalable/mimetypes/small/48x48/help.svg	mismatch	1193485	574690	618795	154
svgs/oxygen-icons-5.113.0/scalable/mimetypes/small/48x48/image-svg+xml-compressed.svg	pass	699918	107156	592762	0
svgs/oxygen-icons-5.113.0/scalable/mimetypes/small/48x48/image-svg+xml.svg	pass	32347	15193	17154	0
svgs/oxygen-icons-5.113.0/scalable/mimetypes/small/48x48/image-vnd.dgn.svg	pass	139277	27639	111638	0
svgs/oxygen-icons-5.113.0/scalable/mimetypes/small/48x48/image-vnd.dwg.svg	pass	137659	27291	110368	0
svgs/oxygen-icons-5.113.0/scalable/mimetypes/small/48x48/image-x-adobe-dng.svg	pass	193631	154504	39127	0
svgs/oxygen-icons-5.113.0/scalable/mimetypes/small/48x48/image-x-eps.svg	pass	35319	15316	20003	0
svgs/oxygen-icons-5.113.0/scalable/mimetypes/small/48x48/image-x-generic.svg	pass	192221	153724	38497	0
svgs/oxygen-icons-5.113.0/scalable/mimetypes/small/48x48/image-x-vnd.trolltech.qpicture.svg	pass	43094	15325	27769	0
svgs/oxygen-icons-5.113.0/scalable/mimetypes/small/48x48/image-x-xfig.svg	pass	32347	15193	17154	0
svgs/oxygen-icons-5.113.0/scalable/mimetypes/small/48x48/inode-directory.svg	pass	134353	120930	13423	0
svgs/oxygen-icons-5.113.0/scalable/mimetypes/small/48x48/message-news.svg	pass	143096	7398	135698	0
svgs/oxygen-icons-5.113.0/scalable/mimetypes/small/48x48/message-partial.svg	pass	247989	137330	110659	1
svgs/oxygen-icons-5.113.0/scalable/mimetypes/small/48x48/message-rfc822.svg	pass	244355	136514	107841	1
svgs/oxygen-icons-5.113.0/scalable/mimetypes/small/48x48/message-x-gnu-rmail.svg	pass	244355	136514	107841	1
svgs/oxygen-icons-5.113.0/scalable/mimetypes/small/48x48/message.svg	pass	244355	136514	107841	1
svgs/oxygen-icons-5.113.0/scalable/mimetypes/small/48x48/mime2.svg	pass	15311	6952	8359	0
svgs/oxygen-icons-5.113.0/scalable/mimetypes/small/48x48/package-x-generic.svg	pass	72870	35885	36985	0
svgs/oxygen-icons-5.113.0/scalable/mimetypes/small/48x48/text-calendar.svg	pass	163048	36118	126930	0
svgs/oxygen-icons-5.113.0/scalable/mimetypes/small/48x48/text-css.svg	pass	390889	185845	205044	0
svgs/oxygen-icons-5.113.0/scalable/mimetypes/small/48x48/text-csv.svg	pass	74813	23465	51348	0
svgs/oxygen-icons-5.113.0/scalable/mimetypes/small/48x48/text-directory.svg	pass	90513	45910	44603	0
svgs/oxygen-icons-5.113.0/scalable/mimetypes/small/48x48/text-enriched.svg	pass	191038	127140	63898	0
svgs/oxygen-icons-5.113.0/scalable/mimetypes/small/48x48/text-html.svg	pass	2386718	1124927	1261791	0
svgs/oxygen-icons-5.113.0/scalable/mimetypes/small/48x48/text-mathml.svg	pass	108904	59277	49627	0
svgs/oxygen-icons-5.113.0/scalable/mimetypes/small/48x48/text-plain.svg	pass	409417	193643	215774	0
svgs/oxygen-icons-5.113.0/scalable/mimetypes/small/48x48/text-rdf+xml.svg	pass	1580577	782872	797705	0
svgs/oxygen-icons-5.113.0/scalable/mimetypes/small/48x48/text-rdf.svg	pass	1580577	782872	797705	0
svgs/oxygen-icons-5.113.0/scalable/mimetypes/small/48x48/text-rtf.svg	pass	875720	465086	410634	0
svgs/oxygen-icons-5.113.0/scalable/mimetypes/small/48x48/text-sgml.svg	pass	146088	123781	22307	0
svgs/oxygen-icons-5.113.0/scalable/mimetypes/small/48x48/text-troff.svg	pass	303054	93819	209235	2
svgs/oxygen-icons-5.113.0/scalable/mimetypes/small/48x48/text-vcalendar.svg	pass	173874	43026	130848	0
svgs/oxygen-icons-5.113.0/scalable/mimetypes/small/48x48/text-vnd.abc.svg	pass	118635	48428	70207	0
svgs/oxygen-icons-5.113.0/scalable/mimetypes/small/48x48/text-vnd.wap.wml.svg	pass	502846	200972	301874	0
svgs/oxygen-icons-5.113.0/scalable/mimetypes/small/48x48/text-x-authors.svg	pass	164641	131831	32810	1
svgs/oxygen-icons-5.113.0/scalable/mimetypes/small/48x48/text-x-bibtex.svg	pass	95922	12604	83318	0
svgs/oxygen-icons-5.113.0/scalable/mimetypes/small/48x48/text-x-c++hdr.svg	pass	51953	23137	28816	0
svgs/oxygen-icons-5.113.0/scalable/mimetypes/small/48x48/text-x-c++src.svg	pass	43937	21064	22873	0
svgs/oxygen-icons-5.113.0/scalable/mimetypes/small/48x48/text-x-changelog.svg	pass	409417	193643	215774	0
svgs/oxygen-icons-5.113.0/scalable/mimetypes/small/48x48/text-x-chdr.svg	pass	37863	16950	20913	0
svgs/oxygen-icons-5.113.0/scalable/mimetypes/small/48x48/text-x-cmake.svg	pass	290331	162379	127952	1
svgs/oxygen-icons-5.113.0/scalable/mimetypes/small/48x48/text-x-copying.svg	pass	278015	136391	141624	0
svgs/oxygen-icons-5.113.0/scalable/mimetypes/small/48x48/text-x-csharp.svg	pass	69407	29240	40167	0
svgs/oxygen-icons-5.113.0/scalable/mimetypes/small/48x48/text-x-csrc.svg	pass	40055	20020	20035	0
svgs/oxygen-icons-5.113.0/scalable/mimetypes/small/48x48/text-x-dtd.svg	pass	502846	200972	301874	0
svgs/oxygen-icons-5.113.0/scalable/mimetypes/small/48x48/text-x-generic.svg	pass	146088	123781	22307	0
svgs/oxygen-icons-5.113.0/scalable/mimetypes/small/48x48/text-x-haskell.svg	pass	183649	101464	82185	1
svgs/oxygen-icons-5.113.0/scalable/mimetypes/small/48x48/text-x-hex.svg	pass	26153	12355	13798	3
svgs/oxygen-icons-5.113.0/scalable/mimetypes/small/48x48/text-x-install.svg	pass	287055	145226	141829	2
svgs/oxygen-icons-5.113.0/scalable/mimetypes/small/48x48/text-x-java.svg	pass	190406	56553	133853	0
svgs/oxygen-icons-5.113.0/scalable/mimetypes/small/48x48/text-x-katefilelist.svg	pass	240501	140311	100190	3
svgs/oxygen-icons-5.113.0/scalable/mimetypes/small/48x48/text-x-ldif.svg	pass	90980	45833	45147	0
svgs/oxygen-icons-5.113.0/scalable/mimetypes/small/48x48/text-x-lilypond.svg	pass	128951	32143	96808	0
svgs/oxygen-icons-5.113.0/scalable/mimetypes/small/48x48/text-x-log.svg	pass	207654	125347	82307	1
svgs/oxygen-icons-5.113.0/scalable/mimetypes/small/48x48/text-x-makefile.svg	pass	317766	95247	222519	0
svgs/oxygen-icons-5.113.0/scalable/mimetypes/small/48x48/text-x-nfo.svg	pass	146088	123781	22307	0
svgs/oxygen-icons-5.113.0/scalable/mimetypes/small/48x48/text-x-objchdr.svg	pass	37863	16950	20913	0
svgs/oxygen-icons-5.113.0/scalable/mimetypes/small/48x48/text-x-objcsrc.svg	pass	40055	20020	20035	0
svgs/oxygen-icons-5.113.0/scalable/mimetypes/small/48x48/text-x-pascal.svg	pass	1344929	1049040	295889	0
svgs/oxygen-icons-5.113.0/scalable/mimetypes/small/48x48/text-x-patch.svg	pass	122141	30930	91211	0
svgs/oxygen-icons-5.113.0/scalable/mimetypes/small/48x48/text-x-po.svg	pass	460662	319176	141486	0
svgs/oxygen-icons-5.113.0/scalable/mimetypes/small/48x48/text-x-python.svg	pass	46124	27125	18999	0
svgs/oxygen-icons-5.113.0/scalable/mimetypes/small/48x48/text-x-qml.svg	pass	35393	19244	16149	0
svgs/oxygen-icons-5.113.0/scalable/mimetypes/small/48x48/text-x-readme.svg	pass	573165	336946	236219	1
svgs/oxygen-icons-5.113.0/scalable/mimetypes/small/48x48/text-x-rpm-spec.svg	pass	23174	10748	12426	0
svgs/oxygen-icons-5.113.0/scalable/mimetypes/small/48x48/text-x-script.svg	pass	790540	10671	779869	0
svgs/oxygen-icons-5.113.0/scalable/mimetypes/small/48x48/text-x-sql.svg	pass	89094	38714	50380	0
svgs/oxygen-icons-5.113.0/scalable/mimetypes/small/48x48/text-x-tex.svg	pass	95922	12604	83318	0
svgs/oxygen-icons-5.113.0/scalable/mimetypes/small/48x48/text-x-texinfo.svg	pass	32588	15524	17064	0
svgs/oxygen-icons-5.113.0/scalable/mimetypes/small/48x48/text-x-vcard.svg	pass	90980	45833	45147	0
svgs/oxygen-icons-5.113.0/scalable/mimetypes/small/48x48/text-x-xslfo.svg	pass	502846	200972	301874	0
svgs/oxygen-icons-5.113.0/scalable/mimetypes/small/48x48/text-xmcd.svg	pass	126876	54418	72458	0
svgs/oxygen-icons-5.113.0/scalable/mimetypes/small/48x48/text-xml.svg	pass	41745	18924	22821	0
svgs/oxygen-icons-5.113.0/scalable/mimetypes/small/48x48/unknown.svg	pass	37542	20168	17374	0
svgs/oxygen-icons-5.113.0/scalable/mimetypes/small/48x48/uri-mms.svg	pass	1614065	786597	827468	0
svgs/oxygen-icons-5.113.0/scalable/mimetypes/small/48x48/uri-mmst.svg	pass	1614065	786597	827468	0
svgs/oxygen-icons-5.113.0/scalable/mimetypes/small/48x48/uri-mmsu.svg	pass	1614065	786597	827468	0
svgs/oxygen-icons-5.113.0/scalable/mimetypes/small/48x48/uri-pnm.svg	pass	1614065	786597	827468	0
svgs/oxygen-icons-5.113.0/scalable/mimetypes/small/48x48/uri-rtspt.svg	pass	1614065	786597	827468	0
svgs/oxygen-icons-5.113.0/scalable/mimetypes/small/48x48/uri-rtspu.svg	pass	1614065	786597	827468	0
svgs/oxygen-icons-5.113.0/scalable/mimetypes/small/48x48/video-x-generic.svg	pass	89625	33633	55992	0
svgs/oxygen-icons-5.113.0/scalable/mimetypes/small/48x48/video-x-mng.svg	pass	192221	153724	38497	0
svgs/oxygen-icons-5.113.0/scalable/mimetypes/small/48x48/x-kde-nsplugin-generated.svg	pass	77688	45890	31798	0
svgs/oxygen-icons-5.113.0/scalable/mimetypes/small/48x48/x-media-podcast.svg	pass	75001	32877	42124	0
svgs/oxygen-icons-5.113.0/scalable/mimetypes/small/48x48/x-office-address-book.svg	pass	3008744	2339532	669212	0
svgs/oxygen-icons-5.113.0/scalable/mimetypes/small/48x48/x-office-calendar.svg	pass	173874	43026	130848	0
svgs/oxygen-icons-5.113.0/scalable/mimetypes/small/48x48/x-office-document.svg	pass	32676	13840	18836	0
svgs/oxygen-icons-5.113.0/scalable/mimetypes/small/48x48/x-office-presentation.svg	pass	128218	21494	106724	0
svgs/oxygen-icons-5.113.0/scalable/mimetypes/small/48x48/x-office-spreadsheet.svg	pass	67958	18859	49099	0
svgs/oxygen-icons-5.113.0/scalable/mimetypes/small/64x64/application-epub+zip.svg	pass	2409547	1967188	442359	0
svgs/oxygen-icons-5.113.0/scalable/mimetypes/small/64x64/application-illustrator.svg	pass	64537	16607	47930	0
svgs/oxygen-icons-5.113.0/scalable/mimetypes/small/64x64/application-javascript.svg	pass	102374	22936	79438	0
svgs/oxygen-icons-5.113.0/scalable/mimetypes/small/64x64/application-msword-template.svg	pass	886661	500193	386468	0
svgs/oxygen-icons-5.113.0/scalable/mimetypes/small/64x64/application-msword.svg	pass	849843	488488	361355	0
svgs/oxygen-icons-5.113.0/scalable/mimetypes/small/64x64/application-octet-stream.svg	pass	277376	153450	123926	0
svgs/oxygen-icons-5.113.0/scalable/mimetypes/small/64x64/application-pdf.svg	pass	56683	9492	47191	0
svgs/oxygen-icons-5.113.0/scalable/mimetypes/small/64x64/application-pgp-encrypted.svg	pass	480613	32344	448269	0
svgs/oxygen-icons-5.113.0/scalable/mimetypes/small/64x64/application-pgp-keys.svg	pass	410038	81753	328285	1
svgs/oxygen-icons-5.113.0/scalable/mimetypes/small/64x64/application-pkcs7-mime.svg	pass	411918	82638	329280	1
svgs/oxygen-icons-5.113.0/scalable/mimetypes/small/64x64/application-postscript.svg	pass	132798	42009	90789	0
svgs/oxygen-icons-5.113.0/scalable/mimetypes/small/64x64/application-relaxng.svg	pass	1687126	604394	1082732	0
svgs/oxygen-icons-5.113.0/scalable/mimetypes/small/64x64/application-rtf.svg	pass	185313	124925	60388	0
svgs/oxygen-icons-5.113.0/scalable/mimetypes/small/64x64/application-sxw.svg	pass	244379	158258	86121	0
svgs/oxygen-icons-5.113.0/scalable/mimetypes/small/64x64/application-vnd-google-earth-kml.svg	pass	54067	9672	44395	0
svgs/oxygen-icons-5.113.0/scalable/mimetypes/small/64x64/application-vnd.iccprofile.svg	pass	199364	53852	145512	0
svgs/oxygen-icons-5.113.0/scalable/mimetypes/small/64x64/application-vnd.ms-access.svg	pass	262959	63890	199069	0
svgs/oxygen-icons-5.113.0/scalable/mimetypes/small/64x64/application-vnd.ms-excel.svg	pass	67762	24916	42846	0
svgs/oxygen-icons-5.113.0/scalable/mimetypes/small/64x64/application-vnd.ms-powerpoint.svg	pass	147783	30230	117553	0
svgs/oxygen-icons-5.113.0/scalable/mimetypes/small/64x64/application-vnd.oasis.opendocument.chart.svg	pass	261622	63819	197803	0
svgs/oxygen-icons-5.113.0/scalable/mimetypes/small/64x64/application-vnd.oasis.opendocument.database.svg	pass	710388	168117	542271	0
svgs/oxygen-icons-5.113.0/scalable/mimetypes/small/64x64/application-vnd.oasis.opendocument.formula-template.svg	pass	609106	172066	437040	0
svgs/oxygen-icons-5.113.0/scalable/mimetypes/small/64x64/application-vnd.oasis.opendocument.formula.svg	pass	349899	159390	190509	0
svgs/oxygen-icons-5.113.0/scalable/mimetypes/small/64x64/application-vnd.oasis.opendocument.graphics.svg	pass	182400	32848	149552	0
svgs/oxygen-icons-5.113.0/scalable/mimetypes/small/64x64/application-vnd.oasis.opendocument.image.svg	pass	318745	115203	203542	0
svgs/oxygen-icons-5.113.0/scalable/mimetypes/small/64x64/application-vnd.oasis.opendocument.presentation-template.svg	pass	253872	38463	215409	0
svgs/oxygen-icons-5.113.0/scalable/mimetypes/small/64x64/application-vnd.oasis.opendocument.presentation.svg	pass	213612	32625	180987	0
svgs/oxygen-icons-5.113.0/scalable/mimetypes/small/64x64/application-vnd.oasis.opendocument.spreadsheet-template.svg	pass	117511	32892	84619	0
svgs/oxygen-icons-5.113.0/scalable/mimetypes/small/64x64/application-vnd.oasis.opendocument.spreadsheet.svg	pass	110842	21606	89236	0
svgs/oxygen-icons-5.113.0/scalable/mimetypes/small/64x64/application-vnd.oasis.opendocument.text.svg	pass	908251	487280	420971	0
svgs/oxygen-icons-5.113.0/scalable/mimetypes/small/64x64/application-vnd.openxmlformats-officedocument.wordprocessingml.document.svg	pass	908251	487280	420971	0
svgs/oxygen-icons-5.113.0/scalable/mimetypes/small/64x64/application-vnd.rn-realmedia.svg	pass	115544	33488	82056	0
svgs/oxygen-icons-5.113.0/scalable/mimetypes/small/64x64/application-vnd.scribus.svg	pass	569704	126184	443520	0
svgs/oxygen-icons-5.113.0/scalable/mimetypes/small/64x64/application-vnd.stardivision.calc.svg	pass	110842	21606	89236	0
svgs/oxygen-icons-5.113.0/scalable/mimetypes/small/64x64/application-vnd.stardivision.draw.svg	pass	318745	115203	203542	0
svgs/oxygen-icons-5.113.0/scalable/mimetypes/small/64x64/application-vnd.stardivision.mail.svg	pass	920656	374492	546164	0
svgs/oxygen-icons-5.113.0/scalable/mimetypes/small/64x64/application-vnd.stardivision.math.svg	pass	349899	159390	190509	0
svgs/oxygen-icons-5.113.0/scalable/mimetypes/small/64x64/application-vnd.sun.xml.calc.svg	pass	110842	21606	89236	0
svgs/oxygen-icons-5.113.0/scalable/mimetypes/small/64x64/application-vnd.sun.xml.calc.template.svg	pass	117511	32892	84619	0
svgs/oxygen-icons-5.113.0/scalable/mimetypes/small/64x64/application-vnd.sun.xml.draw.svg	pass	318745	115203	203542	0
svgs/oxygen-icons-5.113.0/scalable/mimetypes/small/64x64/application-vnd.sun.xml.draw.template.svg	pass	367472	127089	240383	0
svgs/oxygen-icons-5.113.0/scalable/mimetypes/small/64x64/application-vnd.sun.xml.math.svg	pass	349899	159390	190509	0
svgs/oxygen-icons-5.113.0/scalable/mimetypes/small/64x64/application-vnd.sun.xml.writer.template.svg	pass	884251	498869	385382	0
svgs/oxygen-icons-5.113.0/scalable/mimetypes/small/64x64/application-vnd.wordperfect.svg	pass	839708	487917	351791	0
svgs/oxygen-icons-5.113.0/scalable/mimetypes/small/64x64/application-x-7z-compressed.svg	pass	244880	101398	143482	0
svgs/oxygen-icons-5.113.0/scalable/mimetypes/small/64x64/application-x-abiword.svg	pass	908251	487280	420971	0
svgs/oxygen-icons-5.113.0/scalable/mimetypes/small/64x64/application-x-ace.svg	pass	244880	101398	143482	0
svgs/oxygen-icons-5.113.0/scalable/mimetypes/small/64x64/application-x-applix-spreadsheet.svg	pass	110842	21606	89236	0
svgs/oxygen-icons-5.113.0/scalable/mimetypes/small/64x64/application-x-applix-word.svg	pass	888773	478909	409864	0
svgs/oxygen-icons-5.113.0/scalable/mimetypes/small/64x64/application-x-ar.svg	pass	113574	35937	77637	0
svgs/oxygen-icons-5.113.0/scalable/mimetypes/small/64x64/application-x-arc.svg	pass	244880	101398	143482	0
svgs/oxygen-icons-5.113.0/scalable/mimetypes/small/64x64/application-x-archive.svg	pass	113574	35937	77637	0
svgs/oxygen-icons-5.113.0/scalable/mimetypes/small/64x64/application-x-arj.svg	pass	244880	101398	143482	0
svgs/oxygen-icons-5.113.0/scalable/mimetypes/small/64x64/application-x-bittorrent.svg	pass	261757	125432	136325	0
svgs/oxygen-icons-5.113.0/scalable/mimetypes/small/64x64/application-x-blender.svg	pass	109608	31044	78564	0
svgs/oxygen-icons-5.113.0/scalable/mimetypes/small/64x64/application-x-bzdvi.svg	pass	242831	100517	142314	0
svgs/oxygen-icons-5.113.0/scalable/mimetypes/small/64x64/application-x-bzip-compressed-tar.svg	pass	244880	101398	143482	0
svgs/oxygen-icons-5.113.0/scalable/mimetypes/small/64x64/application-x-bzip.svg	pass	320590	91525	229065	0
svgs/oxygen-icons-5.113.0/scalable/mimetypes/small/64x64/application-x-cd-image.svg	pass	171924	58515	113409	0
svgs/oxygen-icons-5.113.0/scalable/mimetypes/small/64x64/application-x-cda.svg	pass	184262	72875	111387	0
svgs/oxygen-icons-5.113.0/scalable/mimetypes/small/64x64/application-x-chm.svg	pass	78603	12241	66362	0
svgs/oxygen-icons-5.113.0/scalable/mimetypes/small/64x64/application-x-compress.svg	pass	320590	91525	229065	0
svgs/oxygen-icons-5.113.0/scalable/mimetypes/small/64x64/application-x-compressed-tar.svg	pass	121631	39668	81963	0
svgs/oxygen-icons-5.113.0/scalable/mimetypes/small/64x64/application-x-cpio.svg	pass	113574	35937	77637	0
svgs/oxygen-icons-5.113.0/scalable/mimetypes/small/64x64/application-x-cue.svg	pass	321190	179192	141998	0
svgs/oxygen-icons-5.113.0/scalable/mimetypes/small/64x64/application-x-deb.svg	pass	125940	41060	84880	1
svgs/oxygen-icons-5.113.0/scalable/mimetypes/small/64x64/application-x-designer.svg	pass	182635	56455	126180	0
svgs/oxygen-icons-5.113.0/scalable/mimetypes/small/64x64/application-x-desktop.svg	pass	91674	43100	48574	0
svgs/oxygen-icons-5.113.0/scalable/mimetypes/small/64x64/application-x-dgn.svg	pass	338900	55540	283360	0
svgs/oxygen-icons-5.113.0/scalable/mimetypes/small/64x64/application-x-egon.svg	pass	251295	155661	95634	0
svgs/oxygen-icons-5.113.0/scalable/mimetypes/small/64x64/application-x-executable-script.svg	pass	129700	51328	78372	0
svgs/oxygen-icons-5.113.0/scalable/mimetypes/small/64x64/application-x-executable.svg	pass	91674	43100	48574	0
svgs/oxygen-icons-5.113.0/scalable/mimetypes/small/64x64/application-x-font-afm.svg	pass	136597	30009	106588	0
svgs/oxygen-icons-5.113.0/scalable/mimetypes/small/64x64/application-x-font-bdf.svg	pass	109486	31930	77556	0
svgs/oxygen-icons-5.113.0/scalable/mimetypes/small/64x64/application-x-font-otf.svg	pass	111508	34338	77170	0
svgs/oxygen-icons-5.113.0/scalable/mimetypes/small/64x64/application-x-font-pcf.svg	pass	109486	31930	77556	0
svgs/oxygen-icons-5.113.0/scalable/mimetypes/small/64x64/application-x-font-snf.svg	pass	109486	31930	77556	0
svgs/oxygen-icons-5.113.0/scalable/mimetypes/small/64x64/application-x-font-ttf.svg	pass	108060	28755	79305	0
svgs/oxygen-icons-5.113.0/scalable/mimetypes/small/64x64/application-x-font-type1.svg	pass	137521	30129	107392	0
svgs/oxygen-icons-5.113.0/scalable/mimetypes/small/64x64/application-x-gnumeric.svg	pass	110842	21606	89236	0
svgs/oxygen-icons-5.113.0/scalable/mimetypes/small/64x64/application-x-gzdvi.svg	pass	242831	100517	142314	0
svgs/oxygen-icons-5.113.0/scalable/mimetypes/small/64x64/application-x-gzip.svg	pass	320590	91525	229065	0
svgs/oxygen-icons-5.113.0/scalable/mimetypes/small/64x64/application-x-gzpostscript.svg	pass	333846	111604	222242	0
svgs/oxygen-icons-5.113.0/scalable/mimetypes/small/64x64/application-x-it87.svg	pass	200546	53972	146574	0
svgs/oxygen-icons-5.113.0/scalable/mimetypes/small/64x64/application-x-java-applet.svg	pass	1613551	792922	820629	0
svgs/oxygen-icons-5.113.0/scalable/mimetypes/small/64x64/application-x-java-archive.svg	pass	118962	38640	80322	0
svgs/oxygen-icons-5.113.0/scalable/mimetypes/small/64x64/application-x-java.svg	pass	133771	46408	87363	1
svgs/oxygen-icons-5.113.0/scalable/mimetypes/small/64x64/application-x-javascript.svg	pass	102374	22936	79438	0
svgs/oxygen-icons-5.113.0/scalable/mimetypes/small/64x64/application-x-k3b.svg	mismatch	323873	181834	142039	122
svgs/oxygen-icons-5.113.0/scalable/mimetypes/small/64x64/application-x-kcsrc.svg	pass	156683	51276	105407	2
svgs/oxygen-icons-5.113.0/scalable/mimetypes/small/64x64/application-x-kexi-connectiondata.svg	pass	771696	183241	588455	0
svgs/oxygen-icons-5.113.0/scalable/mimetypes/small/64x64/application-x-kexiproject-shortcut.svg	pass	772295	183558	588737	0
svgs/oxygen-icons-5.113.0/scalable/mimetypes/small/64x64/application-x-kformula.svg	pass	349899	159390	190509	0
svgs/oxygen-icons-5.113.0/scalable/mimetypes/small/64x64/application-x-kgetlist.svg	pass	107998	32172	75826	0
svgs/oxygen-icons-5.113.0/scalable/mimetypes/small/64x64/application-x-kontour.svg	pass	147080	24488	122592	0
svgs/oxygen-icons-5.113.0/scalable/mimetypes/small/64x64/application-x-kplato.svg	pass	48335	19533	28802	0
svgs/oxygen-icons-5.113.0/scalable/mimetypes/small/64x64/application-x-krita.svg	pass	264240	95127	169113	0
svgs/oxygen-icons-5.113.0/scalable/mimetypes/small/64x64/application-x-kword.svg	pass	908251	487280	420971	0
svgs/oxygen-icons-5.113.0/scalable/mimetypes/small/64x64/application-x-lha.svg	pass	244880	101398	143482	0
svgs/oxygen-icons-5.113.0/scalable/mimetypes/small/64x64/application-x-lyx.svg	pass	902593	484416	418177	0
svgs/oxygen-icons-5.113.0/scalable/mimetypes/small/64x64/application-x-lzma-compressed-tar.svg	pass	113574	35937	77637	0
svgs/oxygen-icons-5.113.0/scalable/mimetypes/small/64x64/application-x-lzop.svg	pass	320590	91525	229065	0
svgs/oxygen-icons-5.113.0/scalable/mimetypes/small/64x64/application-x-m4.svg	pass	276043	122672	153371	0
svgs/oxygen-icons-5.113.0/scalable/mimetypes/small/64x64/application-x-marble.svg	pass	578928	225697	353231	0
svgs/oxygen-icons-5.113.0/scalable/mimetypes/small/64x64/application-x-mimearchive.svg	pass	920656	374492	546164	0
svgs/oxygen-icons-5.113.0/scalable/mimetypes/small/64x64/application-x-mplayer2.svg	pass	115962	33608	82354	0
svgs/oxygen-icons-5.113.0/scalable/mimetypes/small/64x64/application-x-ms-dos-executable.svg	pass	135467	51595	83872	0
svgs/oxygen-icons-5.113.0/scalable/mimetypes/small/64x64/application-x-mswinurl.svg	pass	2237324	1122125	1115199	0
svgs/oxygen-icons-5.113.0/scalable/mimetypes/small/64x64/application-x-mswrite.svg	pass	891387	459801	431586	0
svgs/oxygen-icons-5.113.0/scalable/mimetypes/small/64x64/application-x-nzb.svg	pass	73616	13663	59953	0
svgs/oxygen-icons-5.113.0/scalable/mimetypes/small/64x64/application-x-object.svg	pass	277376	153450	123926	0
svgs/oxygen-icons-5.113.0/scalable/mimetypes/small/64x64/application-x-pak.svg	pass	320590	91525	229065	0
svgs/oxygen-icons-5.113.0/scalable/mimetypes/small/64x64/application-x-pem-key.svg	pass	410038	81753	328285	1
svgs/oxygen-icons-5.113.0/scalable/mimetypes/small/64x64/application-x-perl.svg	pass	906934	511754	395180	0
svgs/oxygen-icons-5.113.0/scalable/mimetypes/small/64x64/application-x-php.svg	pass	115096	35441	79655	0
svgs/oxygen-icons-5.113.0/scalable/mimetypes/small/64x64/application-x-plasma.svg	pass	174857	71422	103435	0
svgs/oxygen-icons-5.113.0/scalable/mimetypes/small/64x64/application-x-python-bytecode.svg	pass	277376	153450	123926	0
svgs/oxygen-icons-5.113.0/scalable/mimetypes/small/64x64/application-x-qet-element.svg	pass	213185	20326	192859	0
svgs/oxygen-icons-5.113.0/scalable/mimetypes/small/64x64/application-x-qet-project.svg	pass	266425	59094	207331	0
svgs/oxygen-icons-5.113.0/scalable/mimetypes/small/64x64/application-x-quattropro.svg	pass	110842	21606	89236	0
svgs/oxygen-icons-5.113.0/scalable/mimetypes/small/64x64/application-x-rar.svg	pass	244880	101398	143482	0
svgs/oxygen-icons-5.113.0/scalable/mimetypes/small/64x64/application-x-rpm.svg	pass	126508	41490	85018	1
svgs/oxygen-icons-5.113.0/scalable/mimetypes/small/64x64/application-x-ruby.svg	pass	252746	70206	182540	0
svgs/oxygen-icons-5.113.0/scalable/mimetypes/small/64x64/application-x-sharedlib.svg	pass	277376	153450	123926	0
svgs/oxygen-icons-5.113.0/scalable/mimetypes/small/64x64/application-x-shellscript.svg	pass	767725	13575	754150	0
svgs/oxygen-icons-5.113.0/scalable/mimetypes/small/64x64/application-x-shockwave-flash.svg	pass	115595	33536	82059	0
svgs/oxygen-icons-5.113.0/scalable/mimetypes/small/64x64/application-x-siag.svg	pass	110842	21606	89236	0
svgs/oxygen-icons-5.113.0/scalable/mimetypes/small/64x64/application-x-srt.svg	pass	530995	209900	321095	0
svgs/oxygen-icons-5.113.0/scalable/mimetypes/small/64x64/application-x-srtrip.svg	pass	530995	209900	321095	0
svgs/oxygen-icons-5.113.0/scalable/mimetypes/small/64x64/application-x-subrip.svg	pass	531036	209904	321132	0
svgs/oxygen-icons-5.113.0/scalable/mimetypes/small/64x64/application-x-tar.svg	pass	113574	35937	77637	0
svgs/oxygen-icons-5.113.0/scalable/mimetypes/small/64x64/application-x-tarz.svg	pass	244880	101398	143482	0
svgs/oxygen-icons-5.113.0/scalable/mimetypes/small/64x64/application-x-tgif.svg	pass	147080	24488	122592	0
svgs/oxygen-icons-5.113.0/scalable/mimetypes/small/64x64/application-x-trash.svg	pass	88761	15994	72767	0
svgs/oxygen-icons-5.113.0/scalable/mimetypes/small/64x64/application-x-troff-man.svg	pass	137868	13543	124325	0
svgs/oxygen-icons-5.113.0/scalable/mimetypes/small/64x64/application-x-tzo.svg	pass	244880	101398	143482	0
svgs/oxygen-icons-5.113.0/scalable/mimetypes/small/64x64/application-x-wmf.svg	pass	147080	24488	122592	0
svgs/oxygen-icons-5.113.0/scalable/mimetypes/small/64x64/application-x-zerosize.svg	pass	86878	6921	79957	0
svgs/oxygen-icons-5.113.0/scalable/mimetypes/small/64x64/application-x-zoo.svg	pass	244880	101398	143482	0
svgs/oxygen-icons-5.113.0/scalable/mimetypes/small/64x64/application-xhtml+xml.svg	pass	2286145	1126138	1160007	0
svgs/oxygen-icons-5.113.0/scalable/mimetypes/small/64x64/application-xml.svg	pass	118503	24381	94122	0
svgs/oxygen-icons-5.113.0/scalable/mimetypes/small/64x64/application-xsd.svg	pass	1746182	857006	889176	1
svgs/oxygen-icons-5.113.0/scalable/mimetypes/small/64x64/application-xslt+xml.svg	pass	2237730	1121858	1115872	0
svgs/oxygen-icons-5.113.0/scalable/mimetypes/small/64x64/application-zip.svg	pass	244880	101398	143482	0
svgs/oxygen-icons-5.113.0/scalable/mimetypes/small/64x64/audio-ac3.svg	pass	233803	48827	184976	0
svgs/oxygen-icons-5.113.0/scalable/mimetypes/small/64x64/audio-midi.svg	pass	170678	45120	125558	0
svgs/oxygen-icons-5.113.0/scalable/mimetypes/small/64x64/audio-prs.sid.svg	pass	170678	45120	125558	0
svgs/oxygen-icons-5.113.0/scalable/mimetypes/small/64x64/audio-vn.rn-realmedia.svg	pass	115962	33608	82354	0
svgs/oxygen-icons-5.113.0/scalable/mimetypes/small/64x64/audio-vn.rn-realvideo.svg	pass	115962	33608	82354	0
svgs/oxygen-icons-5.113.0/scalable/mimetypes/small/64x64/audio-vnd.rn-realvideo.svg	pass	115962	33608	82354	0
svgs/oxygen-icons-5.113.0/scalable/mimetypes/small/64x64/audio-x-adpcm.svg	pass	140117	43576	96541	0
svgs/oxygen-icons-5.113.0/scalable/mimetypes/small/64x64/audio-x-aiff.svg	pass	140117	43576	96541	0
svgs/oxygen-icons-5.113.0/scalable/mimetypes/small/64x64/audio-x-flac+ogg.svg	pass	233803	48824	184979	0
svgs/oxygen-icons-5.113.0/scalable/mimetypes/small/64x64/audio-x-flac.svg	pass	233803	48824	184979	0
svgs/oxygen-icons-5.113.0/scalable/mimetypes/small/64x64/audio-x-generic.svg	pass	233803	48824	184979	0
svgs/oxygen-icons-5.113.0/scalable/mimetypes/small/64x64/audio-x-monkey.svg	pass	233803	48824	184979	0
svgs/oxygen-icons-5.113.0/scalable/mimetypes/small/64x64/audio-x-speex+ogg.svg	pass	226338	88546	137792	0
svgs/oxygen-icons-5.113.0/scalable/mimetypes/small/64x64/audio-x-wav.svg	pass	140117	43576	96541	0
svgs/oxygen-icons-5.113.0/scalable/mimetypes/small/64x64/encrypted.svg	pass	413014	83108	329906	1
svgs/oxygen-icons-5.113.0/scalable/mimetypes/small/64x64/image-svg+xml-compressed.svg	pass	592252	102282	489970	0
svgs/oxygen-icons-5.113.0/scalable/mimetypes/small/64x64/image-svg+xml.svg	pass	147080	24488	122592	0
svgs/oxygen-icons-5.113.0/scalable/mimetypes/small/64x64/image-vnd.dwg.svg	pass	326898	54914	271984	0
svgs/oxygen-icons-5.113.0/scalable/mimetypes/small/64x64/image-x-adobe-dng.svg	mismatch	727214	577892	149322	52
svgs/oxygen-icons-5.113.0/scalable/mimetypes/small/64x64/image-x-eps.svg	pass	126029	24072	101957	0
svgs/oxygen-icons-5.113.0/scalable/mimetypes/small/64x64/image-x-generic.svg	pass	251817	155661	96156	0
svgs/oxygen-icons-5.113.0/scalable/mimetypes/small/64x64/image-x-mng.svg	pass	251817	155661	96156	0
svgs/oxygen-icons-5.113.0/scalable/mimetypes/small/64x64/image-x-vnd.trolltech.qpicture.svg	pass	125595	24081	101514	0
svgs/oxygen-icons-5.113.0/scalable/mimetypes/small/64x64/image-x-xfig.svg	pass	147080	24488	122592	0
svgs/oxygen-icons-5.113.0/scalable/mimetypes/small/64x64/inode-directory.svg	pass	136279	121247	15032	0
svgs/oxygen-icons-5.113.0/scalable/mimetypes/small/64x64/message-news.svg	pass	145993	9236	136757	0
svgs/oxygen-icons-5.113.0/scalable/mimetypes/small/64x64/message-partial.svg	pass	928886	375385	553501	0
svgs/oxygen-icons-5.113.0/scalable/mimetypes/small/64x64/message-rfc822.svg	pass	920656	374492	546164	0
svgs/oxygen-icons-5.113.0/scalable/mimetypes/small/64x64/message-x-gnu-rmail.svg	pass	920656	374492	546164	0
svgs/oxygen-icons-5.113.0/scalable/mimetypes/small/64x64/message.svg	pass	920656	374492	546164	0
svgs/oxygen-icons-5.113.0/scalable/mimetypes/small/64x64/mime2.svg	pass	87691	6921	80770	0
svgs/oxygen-icons-5.113.0/scalable/mimetypes/small/64x64/package-x-generic.svg	pass	113574	35937	77637	0
svgs/oxygen-icons-5.113.0/scalable/mimetypes/small/64x64/text-calendar.svg	pass	152209	38215	113994	0
svgs/oxygen-icons-5.113.0/scalable/mimetypes/small/64x64/text-css.svg	pass	2044130	957915	1086215	0
svgs/oxygen-icons-5.113.0/scalable/mimetypes/small/64x64/text-csv.svg	pass	116730	26202	90528	0
svgs/oxygen-icons-5.113.0/scalable/mimetypes/small/64x64/text-directory.svg	pass	1031742	58755	972987	0
svgs/oxygen-icons-5.113.0/scalable/mimetypes/small/64x64/text-enriched.svg	pass	185313	124925	60388	0
svgs/oxygen-icons-5.113.0/scalable/mimetypes/small/64x64/text-html.svg	pass	2238504	1122245	1116259	0
svgs/oxygen-icons-5.113.0/scalable/mimetypes/small/64x64/text-mathml.svg	pass	319392	151060	168332	0
svgs/oxygen-icons-5.113.0/scalable/mimetypes/small/64x64/text-plain.svg	pass	512012	194713	317299	0
svgs/oxygen-icons-5.113.0/scalable/mimetypes/small/64x64/text-rdf+xml.svg	pass	2794926	1486822	1308104	0
svgs/oxygen-icons-5.113.0/scalable/mimetypes/small/64x64/text-rdf.svg	pass	2794926	1486822	1308104	0
svgs/oxygen-icons-5.113.0/scalable/mimetypes/small/64x64/text-rtf.svg	pass	888773	478909	409864	0
svgs/oxygen-icons-5.113.0/scalable/mimetypes/small/64x64/text-sgml.svg	pass	222834	124943	97891	0
svgs/oxygen-icons-5.113.0/scalable/mimetypes/small/64x64/text-troff.svg	pass	396925	158409	238516	0
svgs/oxygen-icons-5.113.0/scalable/mimetypes/small/64x64/text-vcalendar.svg	pass	179754	46639	133115	0
svgs/oxygen-icons-5.113.0/scalable/mimetypes/small/64x64/text-vnd.abc.svg	pass	233803	48824	184979	0
svgs/oxygen-icons-5.113.0/scalable/mimetypes/small/64x64/text-vnd.wap.wml.svg	pass	1687126	604394	1082732	0
svgs/oxygen-icons-5.113.0/scalable/mimetypes/small/64x64/text-x-adasrc.svg	pass	103989	26347	77642	0
svgs/oxygen-icons-5.113.0/scalable/mimetypes/small/64x64/text-x-authors.svg	pass	199474	130877	68597	0
svgs/oxygen-icons-5.113.0/scalable/mimetypes/small/64x64/text-x-bibtex.svg	pass	66304	12601	53703	0
svgs/oxygen-icons-5.113.0/scalable/mimetypes/small/64x64/text-x-c++hdr.svg	pass	107377	24397	82980	0
svgs/oxygen-icons-5.113.0/scalable/mimetypes/small/64x64/text-x-c++src.svg	pass	89509	22503	67006	0
svgs/oxygen-icons-5.113.0/scalable/mimetypes/small/64x64/text-x-changelog.svg	pass	512012	194713	317299	0
svgs/oxygen-icons-5.113.0/scalable/mimetypes/small/64x64/text-x-chdr.svg	pass	98811	18345	80466	0
svgs/oxygen-icons-5.113.0/scalable/mimetypes/small/64x64/text-x-cmake.svg	pass	249026	160918	88108	0
svgs/oxygen-icons-5.113.0/scalable/mimetypes/small/64x64/text-x-copying.svg	pass	234300	136994	97306	0
svgs/oxygen-icons-5.113.0/scalable/mimetypes/small/64x64/text-x-csharp.svg	pass	108476	34055	74421	0
svgs/oxygen-icons-5.113.0/scalable/mimetypes/small/64x64/text-x-csrc.svg	pass	89735	22387	67348	0
svgs/oxygen-icons-5.113.0/scalable/mimetypes/small/64x64/text-x-dtd.svg	pass	1687126	604394	1082732	0
svgs/oxygen-icons-5.113.0/scalable/mimetypes/small/64x64/text-x-generic.svg	pass	222834	124943	97891	0
svgs/oxygen-icons-5.113.0/scalable/mimetypes/small/64x64/text-x-haskell.svg	pass	395513	189019	206494	0
svgs/oxygen-icons-5.113.0/scalable/mimetypes/small/64x64/text-x-hex.svg	pass	68567	11011	57556	2
svgs/oxygen-icons-5.113.0/scalable/mimetypes/small/64x64/text-x-install.svg	pass	227495	144655	82840	0
svgs/oxygen-icons-5.113.0/scalable/mimetypes/small/64x64/text-x-java.svg	pass	293713	100651	193062	0
svgs/oxygen-icons-5.113.0/scalable/mimetypes/small/64x64/text-x-katefilelist.svg	pass	244943	132732	112211	2
svgs/oxygen-icons-5.113.0/scalable/mimetypes/small/64x64/text-x-ldif.svg	pass	1033324	83321	950003	0
svgs/oxygen-icons-5.113.0/scalable/mimetypes/small/64x64/text-x-lilypond.svg	pass	129629	31351	98278	0
svgs/oxygen-icons-5.113.0/scalable/mimetypes/small/64x64/text-x-log.svg	pass	185042	124465	60577	0
svgs/oxygen-icons-5.113.0/scalable/mimetypes/small/64x64/text-x-makefile.svg	pass	477119	167971	309148	0
svgs/oxygen-icons-5.113.0/scalable/mimetypes/small/64x64/text-x-nfo.svg	pass	222834	124943	97891	0
svgs/oxygen-icons-5.113.0/scalable/mimetypes/small/64x64/text-x-objchdr.svg	pass	98811	18345	80466	0
svgs/oxygen-icons-5.113.0/scalable/mimetypes/small/64x64/text-x-objcsrc.svg	pass	89735	22387	67348	0
svgs/oxygen-icons-5.113.0/scalable/mimetypes/small/64x64/text-x-pascal.svg	pass	2754532	2083247	671285	0
svgs/oxygen-icons-5.113.0/scalable/mimetypes/small/64x64/text-x-patch.svg	pass	253799	47557	206242	0
svgs/oxygen-icons-5.113.0/scalable/mimetypes/small/64x64/text-x-po.svg	pass	798258	524287	273971	0
svgs/oxygen-icons-5.113.0/scalable/mimetypes/small/64x64/text-x-python.svg	pass	144604	45157	99447	0
svgs/oxygen-icons-5.113.0/scalable/mimetypes/small/64x64/text-x-qml.svg	pass	89093	25897	63196	0
svgs/oxygen-icons-5.113.0/scalable/mimetypes/small/64x64/text-x-readme.svg	pass	981971	443488	538483	0
svgs/oxygen-icons-5.113.0/scalable/mimetypes/small/64x64/text-x-rpm-spec.svg	pass	130004	35020	94984	0
svgs/oxygen-icons-5.113.0/scalable/mimetypes/small/64x64/text-x-script.svg	pass	1950681	1072072	878609	0
svgs/oxygen-icons-5.113.0/scalable/mimetypes/small/64x64/text-x-sql.svg	pass	151710	40010	111700	0
svgs/oxygen-icons-5.113.0/scalable/mimetypes/small/64x64/text-x-tex.svg	pass	66304	12601	53703	0
svgs/oxygen-icons-5.113.0/scalable/mimetypes/small/64x64/text-x-texinfo.svg	pass	364143	137590	226553	0
svgs/oxygen-icons-5.113.0/scalable/mimetypes/small/64x64/text-x-vcard.svg	pass	558905	59452	499453	0
svgs/oxygen-icons-5.113.0/scalable/mimetypes/small/64x64/text-x-xslfo.svg	pass	1687126	604394	1082732	0
svgs/oxygen-icons-5.113.0/scalable/mimetypes/small/64x64/text-xmcd.svg	pass	184262	72875	111387	0
svgs/oxygen-icons-5.113.0/scalable/mimetypes/small/64x64/text-xml.svg	pass	122060	28783	93277	0
svgs/oxygen-icons-5.113.0/scalable/mimetypes/small/64x64/unknown.svg	pass	69442	12733	56709	0
svgs/oxygen-icons-5.113.0/scalable/mimetypes/small/64x64/uri-mms.svg	pass	1630181	785469	844712	0
svgs/oxygen-icons-5.113.0/scalable/mimetypes/small/64x64/uri-mmst.svg	pass	1630181	785469	844712	0
svgs/oxygen-icons-5.113.0/scalable/mimetypes/small/64x64/uri-mmsu.svg	pass	1630181	785469	844712	0
svgs/oxygen-icons-5.113.0/scalable/mimetypes/small/64x64/uri-pnm.svg	pass	1630181	785469	844712	0
svgs/oxygen-icons-5.113.0/scalable/mimetypes/small/64x64/uri-rtspt.svg	pass	1630181	785469	844712	0
svgs/oxygen-icons-5.113.0/scalable/mimetypes/small/64x64/uri-rtspu.svg	pass	1630181	785469	844712	0
svgs/oxygen-icons-5.113.0/scalable/mimetypes/small/64x64/video-x-generic.svg	pass	115962	33608	82354	0
svgs/oxygen-icons-5.113.0/scalable/mimetypes/small/64x64/x-kde-nsplugin-generated.svg	pass	150758	45566	105192	0
svgs/oxygen-icons-5.113.0/scalable/mimetypes/small/64x64/x-media-podcast.svg	pass	156041	32853	123188	0
svgs/oxygen-icons-5.113.0/scalable/mimetypes/small/64x64/x-office-address-book.svg	pass	3029842	2352572	677270	0
svgs/oxygen-icons-5.113.0/scalable/mimetypes/small/64x64/x-office-calendar.svg	pass	152209	38215	113994	0
svgs/oxygen-icons-5.113.0/scalable/mimetypes/small/64x64/x-office-document.svg	pass	638949	124230	514719	0
svgs/oxygen-icons-5.113.0/scalable/mimetypes/small/64x64/x-office-presentation.svg	pass	213612	32625	180987	0
svgs/oxygen-icons-5.113.0/scalable/mimetypes/small/64x64/x-office-spreadsheet.svg	pass	110842	21606	89236	0
svgs/oxygen-icons-5.113.0/scalable/mimetypes/text-calendar.svg	pass	147943	37978	109965	0
svgs/oxygen-icons-5.113.0/scalable/mimetypes/text-css.svg	pass	1922133	877979	1044154	0
svgs/oxygen-icons-5.113.0/scalable/mimetypes/text-csv.svg	pass	92981	27300	65681	0
svgs/oxygen-icons-5.113.0/scalable/mimetypes/text-directory.svg	pass	592089	57985	534104	0
svgs/oxygen-icons-5.113.0/scalable/mimetypes/text-enriched.svg	pass	332943	147607	185336	0
svgs/oxygen-icons-5.113.0/scalable/mimetypes/text-html.svg	pass	2233979	1122118	1111861	0
svgs/oxygen-icons-5.113.0/scalable/mimetypes/text-mathml.svg	pass	316511	150948	165563	0
svgs/oxygen-icons-5.113.0/scalable/mimetypes/text-plain.svg	pass	507293	259934	247359	0
svgs/oxygen-icons-5.113.0/scalable/mimetypes/text-rdf+xml.svg	pass	2651359	1418516	1232843	0
svgs/oxygen-icons-5.113.0/scalable/mimetypes/text-rdf.svg	pass	2651359	1418516	1232843	0
svgs/oxygen-icons-5.113.0/scalable/mimetypes/text-rtf.svg	pass	1530847	881731	649116	0
svgs/oxygen-icons-5.113.0/scalable/mimetypes/text-sgml.svg	pass	496236	215592	280644	0
svgs/oxygen-icons-5.113.0/scalable/mimetypes/text-troff.svg	pass	394417	159106	235311	0
svgs/oxygen-icons-5.113.0/scalable/mimetypes/text-vcalendar.svg	pass	190709	49829	140880	0
svgs/oxygen-icons-5.113.0/scalable/mimetypes/text-vnd.abc.svg	pass	285237	72881	212356	0
svgs/oxygen-icons-5.113.0/scalable/mimetypes/text-vnd.wap.wml.svg	pass	1685920	603990	1081930	0
svgs/oxygen-icons-5.113.0/scalable/mimetypes/text-x-adasrc.svg	pass	99786	26216	73570	0
svgs/oxygen-icons-5.113.0/scalable/mimetypes/text-x-authors.svg	pass	510291	221540	288751	0
svgs/oxygen-icons-5.113.0/scalable/mimetypes/text-x-bibtex.svg	pass	65498	14529	50969	0
svgs/oxygen-icons-5.113.0/scalable/mimetypes/text-x-c++hdr.svg	pass	102444	24539	77905	0
svgs/oxygen-icons-5.113.0/scalable/mimetypes/text-x-c++src.svg	pass	86892	22359	64533	0
svgs/oxygen-icons-5.113.0/scalable/mimetypes/text-x-changelog.svg	pass	507293	259934	247359	0
svgs/oxygen-icons-5.113.0/scalable/mimetypes/text-x-chdr.svg	pass	92946	18563	74383	0
svgs/oxygen-icons-5.113.0/scalable/mimetypes/text-x-cmake.svg	pass	561928	251635	310293	0
svgs/oxygen-icons-5.113.0/scalable/mimetypes/text-x-copying.svg	pass	623326	236133	387193	0
svgs/oxygen-icons-5.113.0/scalable/mimetypes/text-x-csharp.svg	pass	105828	34034	71794	0
svgs/oxygen-icons-5.113.0/scalable/mimetypes/text-x-csrc.svg	pass	84978	22485	62493	0
svgs/oxygen-icons-5.113.0/scalable/mimetypes/text-x-dtd.svg	pass	1685920	603990	1081930	0
svgs/oxygen-icons-5.113.0/scalable/mimetypes/text-x-generic.svg	pass	496236	215592	280644	0
svgs/oxygen-icons-5.113.0/scalable/mimetypes/text-x-haskell.svg	pass	392289	188705	203584	0
svgs/oxygen-icons-5.113.0/scalable/mimetypes/text-x-hex.svg	pass	66268	12270	53998	0
svgs/oxygen-icons-5.113.0/scalable/mimetypes/text-x-install.svg	pass	605088	241281	363807	0
svgs/oxygen-icons-5.113.0/scalable/mimetypes/text-x-java.svg	pass	283703	99891	183812	0
svgs/oxygen-icons-5.113.0/scalable/mimetypes/text-x-katefilelist.svg	mismatch	568691	231234	337457	36
svgs/oxygen-icons-5.113.0/scalable/mimetypes/text-x-ldif.svg	pass	1216331	190623	1025708	0
svgs/oxygen-icons-5.113.0/scalable/mimetypes/text-x-lilypond.svg	pass	559170	276083	283087	0
svgs/oxygen-icons-5.113.0/scalable/mimetypes/text-x-log.svg	pass	496226	215594	280632	0
svgs/oxygen-icons-5.113.0/scalable/mimetypes/text-x-makefile.svg	pass	475350	171597	303753	0
svgs/oxygen-icons-5.113.0/scalable/mimetypes/text-x-nfo.svg	pass	496236	215592	280644	0
svgs/oxygen-icons-5.113.0/scalable/mimetypes/text-x-objchdr.svg	pass	92946	18563	74383	0
svgs/oxygen-icons-5.113.0/scalable/mimetypes/text-x-objcsrc.svg	pass	84978	22485	62493	0
svgs/oxygen-icons-5.113.0/scalable/mimetypes/text-x-pascal.svg	pass	2750634	2083211	667423	0
svgs/oxygen-icons-5.113.0/scalable/mimetypes/text-x-patch.svg	pass	248802	47313	201489	0
svgs/oxygen-icons-5.113.0/scalable/mimetypes/text-x-po.svg	mismatch	794815	524278	270537	9
svgs/oxygen-icons-5.113.0/scalable/mimetypes/text-x-python.svg	pass	135953	44964	90989	0
svgs/oxygen-icons-5.113.0/scalable/mimetypes/text-x-qml.svg	pass	88313	26008	62305	0
svgs/oxygen-icons-5.113.0/scalable/mimetypes/text-x-readme.svg	pass	917051	427042	490009	0
svgs/oxygen-icons-5.113.0/scalable/mimetypes/text-x-rpm-spec.svg	pass	115997	34805	81192	0
svgs/oxygen-icons-5.113.0/scalable/mimetypes/text-x-script.svg	pass	2056462	1072541	983921	0
svgs/oxygen-icons-5.113.0/scalable/mimetypes/text-x-sql.svg	pass	148679	39885	108794	0
svgs/oxygen-icons-5.113.0/scalable/mimetypes/text-x-tcl.svg	pass	16800	8060	8740	0
svgs/oxygen-icons-5.113.0/scalable/mimetypes/text-x-tex.svg	pass	65498	14529	50969	0
svgs/oxygen-icons-5.113.0/scalable/mimetypes/text-x-texinfo.svg	pass	358990	137559	221431	0
svgs/oxygen-icons-5.113.0/scalable/mimetypes/text-x-vcard.svg	pass	553746	59251	494495	0
svgs/oxygen-icons-5.113.0/scalable/mimetypes/text-x-xslfo.svg	pass	1685920	603990	1081930	0
svgs/oxygen-icons-5.113.0/scalable/mimetypes/text-xmcd.svg	pass	172805	68161	104644	0
svgs/oxygen-icons-5.113.0/scalable/mimetypes/text-xml.svg	pass	117301	28946	88355	0
svgs/oxygen-icons-5.113.0/scalable/mimetypes/unknown.svg	pass	64890	12174	52716	0
svgs/oxygen-icons-5.113.0/scalable/mimetypes/uri-mms.svg	pass	1625357	785131	840226	0
svgs/oxygen-icons-5.113.0/scalable/mimetypes/uri-mmst.svg	pass	1625357	785131	840226	0
svgs/oxygen-icons-5.113.0/scalable/mimetypes/uri-mmsu.svg	pass	1625357	785131	840226	0
svgs/oxygen-icons-5.113.0/scalable/mimetypes/uri-pnm.svg	pass	1625357	785131	840226	0
svgs/oxygen-icons-5.113.0/scalable/mimetypes/uri-rtspt.svg	pass	1625357	785131	840226	0
svgs/oxygen-icons-5.113.0/scalable/mimetypes/uri-rtspu.svg	pass	1625357	785131	840226	0
svgs/oxygen-icons-5.113.0/scalable/mimetypes/video-x-generic.svg	pass	112565	33231	79334	0
svgs/oxygen-icons-5.113.0/scalable/mimetypes/video-x-mng.svg	pass	246742	155234	91508	0
svgs/oxygen-icons-5.113.0/scalable/mimetypes/x-kde-nsplugin-generated.svg	pass	145379	45450	99929	0
svgs/oxygen-icons-5.113.0/scalable/mimetypes/x-media-podcast.svg	pass	147640	33802	113838	0
svgs/oxygen-icons-5.113.0/scalable/mimetypes/x-office-address-book.svg	pass	3028464	2351920	676544	0
svgs/oxygen-icons-5.113.0/scalable/mimetypes/x-office-calendar.svg	pass	190709	49829	140880	0
svgs/oxygen-icons-5.113.0/scalable/mimetypes/x-office-contact.svg	pass	59246	33282	25964	0
svgs/oxygen-icons-5.113.0/scalable/mimetypes/x-office-document.svg	pass	210000	127160	82840	0
svgs/oxygen-icons-5.113.0/scalable/mimetypes/x-office-presentation.svg	pass	207440	36001	171439	0
svgs/oxygen-icons-5.113.0/scalable/mimetypes/x-office-spreadsheet.svg	pass	86189	22712	63477	0
svgs/oxygen-icons-5.113.0/scalable/object-rotate.svg	pass	40963	13756	27207	1
svgs/oxygen-icons-5.113.0/scalable/places/bookmarks.svg	pass	82731	42403	40328	2
svgs/oxygen-icons-5.113.0/scalable/places/certificate-server.svg	pass	1278438	547368	731070	2
svgs/oxygen-icons-5.113.0/scalable/places/document-multiple.svg	pass	59743	10868	48875	0
svgs/oxygen-icons-5.113.0/scalable/places/favorites.svg	pass	82731	42403	40328	2
svgs/oxygen-icons-5.113.0/scalable/places/folder-activities.svg	pass	182332	134242	48090	0
svgs/oxygen-icons-5.113.0/scalable/places/folder-black.svg	pass	354277	228860	125417	0
svgs/oxygen-icons-5.113.0/scalable/places/folder-blue.svg	pass	135970	121386	14584	0
svgs/oxygen-icons-5.113.0/scalable/places/folder-bookmark.svg	pass	157581	124472	33109	0
svgs/oxygen-icons-5.113.0/scalable/places/folder-brown.svg	pass	136491	121388	15103	0
svgs/oxygen-icons-5.113.0/scalable/places/folder-cyan.svg	pass	135872	121370	14502	0
svgs/oxygen-icons-5.113.0/scalable/places/folder-development.svg	pass	234001	169259	64742	0
svgs/oxygen-icons-5.113.0/scalable/places/folder-documents.svg	pass	312556	233633	78923	0
svgs/oxygen-icons-5.113.0/scalable/places/folder-downloads.svg	pass	158231	130611	27620	0
svgs/oxygen-icons-5.113.0/scalable/places/folder-favorites.svg	pass	228212	167415	60797	3
svgs/oxygen-icons-5.113.0/scalable/places/folder-games.svg	pass	202042	167579	34463	0
svgs/oxygen-icons-5.113.0/scalable/places/folder-green.svg	pass	135762	121338	14424	0
svgs/oxygen-icons-5.113.0/scalable/places/folder-grey.svg	pass	355208	229464	125744	0
svgs/oxygen-icons-5.113.0/scalable/places/folder-html.svg	pass	1081310	467112	614198	0
svgs/oxygen-icons-5.113.0/scalable/places/folder-image-people.svg	pass	828915	441265	387650	0
svgs/oxygen-icons-5.113.0/scalable/places/folder-image.svg	pass	725990	524103	201887	0
svgs/oxygen-icons-5.113.0/scalable/places/folder-important.svg	pass	206615	125985	80630	0
svgs/oxygen-icons-5.113.0/scalable/places/folder-locked.svg	pass	383951	258371	125580	0
svgs/oxygen-icons-5.113.0/scalable/places/folder-network.svg	pass	162755	133142	29613	0
svgs/oxygen-icons-5.113.0/scalable/places/folder-orange.svg	pass	136196	121384	14812	0
svgs/oxygen-icons-5.113.0/scalable/places/folder-print.svg	pass	182962	143308	39654	0
svgs/oxygen-icons-5.113.0/scalable/places/folder-red.svg	pass	1260094	232545	1027549	0
svgs/oxygen-icons-5.113.0/scalable/places/folder-remote.svg	pass	886692	459630	427062	0
svgs/oxygen-icons-5.113.0/scalable/places/folder-sound.svg	pass	182962	137047	45915	0
svgs/oxygen-icons-5.113.0/scalable/places/folder-tar.svg	pass	213877	133328	80549	0
svgs/oxygen-icons-5.113.0/scalable/places/folder-temp.svg	pass	139847	124093	15754	0
svgs/oxygen-icons-5.113.0/scalable/places/folder-txt.svg	pass	160509	132288	28221	0
svgs/oxygen-icons-5.113.0/scalable/places/folder-video.svg	pass	213640	137041	76599	0
svgs/oxygen-icons-5.113.0/scalable/places/folder-violet.svg	pass	136201	121378	14823	0
svgs/oxygen-icons-5.113.0/scalable/places/folder-yellow.svg	pass	138340	122731	15609	0
svgs/oxygen-icons-5.113.0/scalable/places/folder.svg	pass	135983	121336	14647	0
svgs/oxygen-icons-5.113.0/scalable/places/hidef/folder-black.svg	pass	475912	444840	31072	0
svgs/oxygen-icons-5.113.0/scalable/places/hidef/folder-blue.svg	pass	255145	122696	132449	0
svgs/oxygen-icons-5.113.0/scalable/places/hidef/folder-bookmark.svg	pass	285808	233245	52563	0
svgs/oxygen-icons-5.113.0/scalable/places/hidef/folder-brown.svg	pass	370705	122090	248615	0
svgs/oxygen-icons-5.113.0/scalable/places/hidef/folder-cyan.svg	pass	254050	122526	131524	0
svgs/oxygen-icons-5.113.0/scalable/places/hidef/folder-development.svg	pass	685130	289101	396029	0
svgs/oxygen-icons-5.113.0/scalable/places/hidef/folder-documents.svg	pass	248986	127522	121464	0
svgs/oxygen-icons-5.113.0/scalable/places/hidef/folder-downloads.svg	pass	431573	239120	192453	0
svgs/oxygen-icons-5.113.0/scalable/places/hidef/folder-favorites.svg	pass	349231	275793	73438	0
svgs/oxygen-icons-5.113.0/scalable/places/hidef/folder-green.svg	pass	256463	122691	133772	0
svgs/oxygen-icons-5.113.0/scalable/places/hidef/folder-grey.svg	pass	595573	230718	364855	0
svgs/oxygen-icons-5.113.0/scalable/places/hidef/folder-html.svg	pass	1215287	580745	634542	0
svgs/oxygen-icons-5.113.0/scalable/places/hidef/folder-image-people.svg	pass	825495	439403	386092	0
svgs/oxygen-icons-5.113.0/scalable/places/hidef/folder-image.svg	pass	951000	527462	423538	0
svgs/oxygen-icons-5.113.0/scalable/places/hidef/folder-important.svg	pass	444391	127681	316710	2
svgs/oxygen-icons-5.113.0/scalable/places/hidef/folder-locked.svg	pass	620018	259381	360637	0
svgs/oxygen-icons-5.113.0/scalable/places/hidef/folder-network.svg	pass	400947	135208	265739	0
svgs/oxygen-icons-5.113.0/scalable/places/hidef/folder-orange.svg	pass	252566	122190	130376	0
svgs/oxygen-icons-5.113.0/scalable/places/hidef/folder-print.svg	pass	178109	142045	36064	0
svgs/oxygen-icons-5.113.0/scalable/places/hidef/folder-red.svg	pass	1951223	230274	1720949	0
svgs/oxygen-icons-5.113.0/scalable/places/hidef/folder-remote.svg	pass	894294	568106	326188	0
svgs/oxygen-icons-5.113.0/scalable/places/hidef/folder-sound.svg	pass	326355	244282	82073	0
svgs/oxygen-icons-5.113.0/scalable/places/hidef/folder-tar.svg	pass	828055	243020	585035	2
svgs/oxygen-icons-5.113.0/scalable/places/hidef/folder-temp.svg	pass	377297	233133	144164	0
svgs/oxygen-icons-5.113.0/scalable/places/hidef/folder-txt.svg	pass	296631	255312	41319	0
svgs/oxygen-icons-5.113.0/scalable/places/hidef/folder-video.svg	pass	231761	138788	92973	0
svgs/oxygen-icons-5.113.0/scalable/places/hidef/folder-violet.svg	pass	256273	122743	133530	0
svgs/oxygen-icons-5.113.0/scalable/places/hidef/folder-yellow.svg	pass	248409	122789	125620	0
svgs/oxygen-icons-5.113.0/scalable/places/hidef/folder.svg	pass	137394	122644	14750	0
svgs/oxygen-icons-5.113.0/scalable/places/hidef/mail-folder-sent.svg	pass	494916	132458	362458	0
svgs/oxygen-icons-5.113.0/scalable/places/hidef/mail-message.svg	pass	234315	5934	228381	0
svgs/oxygen-icons-5.113.0/scalable/places/hidef/network-server-database.svg	pass	282163	35750	246413	0
svgs/oxygen-icons-5.113.0/scalable/places/hidef/network-server.svg	pass	726192	224844	501348	0
svgs/oxygen-icons-5.113.0/scalable/places/hidef/network-workgroup.svg	pass	1334275	457579	876696	0
svgs/oxygen-icons-5.113.0/scalable/places/hidef/server-database.svg	pass	273939	24010	249929	0
svgs/oxygen-icons-5.113.0/scalable/places/hidef/user-home.svg	pass	266506	232530	33976	0
svgs/oxygen-icons-5.113.0/scalable/places/hidef/user-trash.svg	pass	60800	18104	42696	0
svgs/oxygen-icons-5.113.0/scalable/places/kmag.svg	pass	1097232	201082	896150	0
svgs/oxygen-icons-5.113.0/scalable/places/mail-folder-inbox.svg	pass	44892	12289	32603	0
svgs/oxygen-icons-5.113.0/scalable/places/mail-folder-outbox.svg	pass	74835	13832	61003	0
svgs/oxygen-icons-5.113.0/scalable/places/mail-folder-sent.svg	pass	261709	129753	131956	0
svgs/oxygen-icons-5.113.0/scalable/places/mail-message.svg	pass	233717	5849	227868	0
svgs/oxygen-icons-5.113.0/scalable/places/network-server-database.svg	pass	282213	35746	246467	4
svgs/oxygen-icons-5.113.0/scalable/places/network-server.svg	pass	375146	232797	142349	0
svgs/oxygen-icons-5.113.0/scalable/places/network-workgroup.svg	pass	983869	456527	527342	0
svgs/oxygen-icons-5.113.0/scalable/places/repository.svg	pass	1286273	667881	618392	0
svgs/oxygen-icons-5.113.0/scalable/places/server-database.svg	pass	273987	24011	249976	4
svgs/oxygen-icons-5.113.0/scalable/places/small/16x16/bookmarks.svg	pass	112992	53757	59235	0
svgs/oxygen-icons-5.113.0/scalable/places/small/16x16/certificate-server.svg	pass	918250	384052	534198	0
svgs/oxygen-icons-5.113.0/scalable/places/small/16x16/document-multiple.svg	pass	187764	7057	180707	0
svgs/oxygen-icons-5.113.0/scalable/places/small/16x16/folder-activities.svg	pass	270474	128737	141737	0
svgs/oxygen-icons-5.113.0/scalable/places/small/16x16/folder-black.svg	pass	68483	7888	60595	0
svgs/oxygen-icons-5.113.0/scalable/places/small/16x16/folder-blue.svg	pass	184072	8457	175615	0
svgs/oxygen-icons-5.113.0/scalable/places/small/16x16/folder-bookmark.svg	pass	369406	226628	142778	0
svgs/oxygen-icons-5.113.0/scalable/places/small/16x16/folder-development.svg	pass	254984	149783	105201	0
svgs/oxygen-icons-5.113.0/scalable/places/small/16x16/folder-documents.svg	pass	251200	124350	126850	0
svgs/oxygen-icons-5.113.0/scalable/places/small/16x16/folder-downloads.svg	pass	76303	8583	67720	0
svgs/oxygen-icons-5.113.0/scalable/places/small/16x16/folder-favorites.svg	pass	170944	141285	29659	0
svgs/oxygen-icons-5.113.0/scalable/places/small/16x16/folder-green.svg	pass	73524	6762	66762	0
svgs/oxygen-icons-5.113.0/scalable/places/small/16x16/folder-grey.svg	pass	82173	8581	73592	0
svgs/oxygen-icons-5.113.0/scalable/places/small/16x16/folder-html.svg	pass	824178	354688	469490	0
svgs/oxygen-icons-5.113.0/scalable/places/small/16x16/folder-image-people.svg	pass	831180	441877	389303	0
svgs/oxygen-icons-5.113.0/scalable/places/small/16x16/folder-image.svg	pass	365425	156506	208919	0
svgs/oxygen-icons-5.113.0/scalable/places/small/16x16/folder-important.svg	pass	142185	12952	129233	0
svgs/oxygen-icons-5.113.0/scalable/places/small/16x16/folder-locked.svg	pass	415421	8621	406800	0
svgs/oxygen-icons-5.113.0/scalable/places/small/16x16/folder-network.svg	pass	577218	127844	449374	0
svgs/oxygen-icons-5.113.0/scalable/places/small/16x16/folder-orange.svg	pass	642323	7479	634844	0
svgs/oxygen-icons-5.113.0/scalable/places/small/16x16/folder-red.svg	pass	79187	8616	70571	0
svgs/oxygen-icons-5.113.0/scalable/places/small/16x16/folder-remote.svg	pass	1822934	561641	1261293	0
svgs/oxygen-icons-5.113.0/scalable/places/small/16x16/folder-sound.svg	pass	621463	232772	388691	0
svgs/oxygen-icons-5.113.0/scalable/places/small/16x16/folder-tar.svg	pass	92990	14953	78037	0
svgs/oxygen-icons-5.113.0/scalable/places/small/16x16/folder-temp.svg	pass	78230	9773	68457	0
svgs/oxygen-icons-5.113.0/scalable/places/small/16x16/folder-txt.svg	pass	505682	234671	271011	0
svgs/oxygen-icons-5.113.0/scalable/places/small/16x16/folder-video.svg	pass	423173	124272	298901	0
svgs/oxygen-icons-5.113.0/scalable/places/small/16x16/folder-violet.svg	pass	411619	7205	404414	0
svgs/oxygen-icons-5.113.0/scalable/places/small/16x16/folder-yellow.svg	pass	67745	7089	60656	0
svgs/oxygen-icons-5.113.0/scalable/places/small/16x16/folder.svg	pass	76737	8430	68307	0
svgs/oxygen-icons-5.113.0/scalable/places/small/16x16/mail-folder-inbox.svg	pass	40105	9092	31013	0
svgs/oxygen-icons-5.113.0/scalable/places/small/16x16/mail-folder-outbox.svg	pass	120512	12770	107742	0
svgs/oxygen-icons-5.113.0/scalable/places/small/16x16/mail-folder-sent.svg	pass	312704	120877	191827	0
svgs/oxygen-icons-5.113.0/scalable/places/small/16x16/mail-message.svg	pass	69671	4736	64935	0
svgs/oxygen-icons-5.113.0/scalable/places/small/16x16/server-database.svg	pass	86833	19961	66872	0
svgs/oxygen-icons-5.113.0/scalable/places/small/16x16/start-here-kde.svg	pass	24156	10086	14070	0
svgs/oxygen-icons-5.113.0/scalable/places/small/16x16/user-desktop.svg	pass	12436	6245	6191	0
svgs/oxygen-icons-5.113.0/scalable/places/small/16x16/user-home.svg	pass	128600	116106	12494	0
svgs/oxygen-icons-5.113.0/scalable/places/small/16x16/user-identity.svg	pass	17826	3590	14236	0
svgs/oxygen-icons-5.113.0/scalable/places/small/16x16/user-trash.svg	pass	60844	17988	42856	0
svgs/oxygen-icons-5.113.0/scalable/places/small/22x22/bookmarks.svg	pass	106190	50163	56027	0
svgs/oxygen-icons-5.113.0/scalable/places/small/22x22/certificate-server.svg	pass	947819	401995	545824	0
svgs/oxygen-icons-5.113.0/scalable/places/small/22x22/document-multiple.svg	pass	18865	6534	12331	0
svgs/oxygen-icons-5.113.0/scalable/places/small/22x22/folder-activities.svg	pass	164097	129474	34623	0
svgs/oxygen-icons-5.113.0/scalable/places/small/22x22/folder-black.svg	pass	696785	224408	472377	0
svgs/oxygen-icons-5.113.0/scalable/places/small/22x22/folder-blue.svg	pass	245257	116842	128415	0
svgs/oxygen-icons-5.113.0/scalable/places/small/22x22/folder-bookmark.svg	pass	137210	119928	17282	0
svgs/oxygen-icons-5.113.0/scalable/places/small/22x22/folder-brown.svg	pass	246197	116465	129732	0
svgs/oxygen-icons-5.113.0/scalable/places/small/22x22/folder-cyan.svg	pass	127391	116454	10937	0
svgs/oxygen-icons-5.113.0/scalable/places/small/22x22/folder-development.svg	pass	509591	151624	357967	0
svgs/oxygen-icons-5.113.0/scalable/places/small/22x22/folder-documents.svg	pass	144737	124633	20104	0
svgs/oxygen-icons-5.113.0/scalable/places/small/22x22/folder-downloads.svg	pass	282701	247090	35611	0
svgs/oxygen-icons-5.113.0/scalable/places/small/22x22/folder-favorites.svg	pass	299671	142015	157656	0
svgs/oxygen-icons-5.113.0/scalable/places/small/22x22/folder-green.svg	pass	480380	116620	363760	0
svgs/oxygen-icons-5.113.0/scalable/places/small/22x22/folder-grey.svg	pass	700540	224448	476092	0
svgs/oxygen-icons-5.113.0/scalable/places/small/22x22/folder-html.svg	pass	996185	467085	529100	0
svgs/oxygen-icons-5.113.0/scalable/places/small/22x22/folder-image-people.svg	pass	831313	441921	389392	0
svgs/oxygen-icons-5.113.0/scalable/places/small/22x22/folder-image.svg	pass	206883	158182	48701	0
svgs/oxygen-icons-5.113.0/scalable/places/small/22x22/folder-important.svg	pass	321297	121268	200029	0
svgs/oxygen-icons-5.113.0/scalable/places/small/22x22/folder-locked.svg	pass	661225	253419	407806	0
svgs/oxygen-icons-5.113.0/scalable/places/small/22x22/folder-network.svg	pass	512338	128825	383513	0
svgs/oxygen-icons-5.113.0/scalable/places/small/22x22/folder-orange.svg	pass	478201	116454	361747	0
svgs/oxygen-icons-5.113.0/scalable/places/small/22x22/folder-print.svg	pass	162417	131526	30891	0
svgs/oxygen-icons-5.113.0/scalable/places/small/22x22/folder-red.svg	pass	563868	224389	339479	0
svgs/oxygen-icons-5.113.0/scalable/places/small/22x22/folder-remote.svg	pass	1591781	454659	1137122	0
svgs/oxygen-icons-5.113.0/scalable/places/small/22x22/folder-sound.svg	pass	257770	125981	131789	0
svgs/oxygen-icons-5.113.0/scalable/places/small/22x22/folder-tar.svg	pass	806517	231007	575510	0
svgs/oxygen-icons-5.113.0/scalable/places/small/22x22/folder-temp.svg	pass	248683	119963	128720	0
svgs/oxygen-icons-5.113.0/scalable/places/small/22x22/folder-txt.svg	pass	274778	127969	146809	0
svgs/oxygen-icons-5.113.0/scalable/places/small/22x22/folder-video.svg	pass	539084	125604	413480	0
svgs/oxygen-icons-5.113.0/scalable/places/small/22x22/folder-violet.svg	pass	245280	116811	128469	0
svgs/oxygen-icons-5.113.0/scalable/places/small/22x22/folder-yellow.svg	pass	246891	116738	130153	0
svgs/oxygen-icons-5.113.0/scalable/places/small/22x22/folder.svg	pass	245747	116833	128914	0
svgs/oxygen-icons-5.113.0/scalable/places/small/22x22/mail-folder-inbox.svg	pass	76572	16409	60163	0
svgs/oxygen-icons-5.113.0/scalable/places/small/22x22/mail-folder-sent.svg	pass	198584	121542	77042	0
svgs/oxygen-icons-5.113.0/scalable/places/small/22x22/mail-message.svg	pass	70215	4739	65476	0
svgs/oxygen-icons-5.113.0/scalable/places/small/22x22/server-database.svg	pass	37358	20079	17279	0
svgs/oxygen-icons-5.113.0/scalable/places/small/22x22/start-here-kde.svg	pass	24756	10044	14712	0
svgs/oxygen-icons-5.113.0/scalable/places/small/22x22/user-desktop.svg	pass	198426	96065	102361	0
svgs/oxygen-icons-5.113.0/scalable/places/small/22x22/user-home.svg	pass	259510	225183	34327	0
svgs/oxygen-icons-5.113.0/scalable/places/small/22x22/user-identity.svg	pass	17912	3579	14333	0
svgs/oxygen-icons-5.113.0/scalable/places/small/22x22/user-trash.svg	pass	60862	18023	42839	0
svgs/oxygen-icons-5.113.0/scalable/places/small/32x32/certificate-server.svg	pass	1678713	478288	1200425	0
svgs/oxygen-icons-5.113.0/scalable/places/small/32x32/folder-activities.svg	pass	161520	133557	27963	0
svgs/oxygen-icons-5.113.0/scalable/places/small/32x32/folder-black.svg	pass	804554	227604	576950	0
svgs/oxygen-icons-5.113.0/scalable/places/small/32x32/folder-blue.svg	pass	369135	119999	249136	0
svgs/oxygen-icons-5.113.0/scalable/places/small/32x32/folder-bookmark.svg	pass	139465	123128	16337	0
svgs/oxygen-icons-5.113.0/scalable/places/small/32x32/folder-brown.svg	pass	132799	119552	13247	0
svgs/oxygen-icons-5.113.0/scalable/places/small/32x32/folder-cyan.svg	pass	133202	119921	13281	0
svgs/oxygen-icons-5.113.0/scalable/places/small/32x32/folder-development.svg	pass	258972	152780	106192	0
svgs/oxygen-icons-5.113.0/scalable/places/small/32x32/folder-documents.svg	pass	151394	127720	23674	0
svgs/oxygen-icons-5.113.0/scalable/places/small/32x32/folder-downloads.svg	pass	300638	129029	171609	0
svgs/oxygen-icons-5.113.0/scalable/places/small/32x32/folder-favorites.svg	pass	464339	165802	298537	0
svgs/oxygen-icons-5.113.0/scalable/places/small/32x32/folder-green.svg	pass	250238	120282	129956	0
svgs/oxygen-icons-5.113.0/scalable/places/small/32x32/folder-grey.svg	pass	351269	227945	123324	0
svgs/oxygen-icons-5.113.0/scalable/places/small/32x32/folder-html.svg	pass	783573	466584	316989	0
svgs/oxygen-icons-5.113.0/scalable/places/small/32x32/folder-image-people.svg	pass	839090	447112	391978	0
svgs/oxygen-icons-5.113.0/scalable/places/small/32x32/folder-image.svg	pass	209079	159260	49819	0
svgs/oxygen-icons-5.113.0/scalable/places/small/32x32/folder-important.svg	pass	449790	124463	325327	0
svgs/oxygen-icons-5.113.0/scalable/places/small/32x32/folder-locked.svg	pass	447889	256635	191254	0
svgs/oxygen-icons-5.113.0/scalable/places/small/32x32/folder-network.svg	pass	154834	131554	23280	0
svgs/oxygen-icons-5.113.0/scalable/places/small/32x32/folder-orange.svg	pass	249832	119858	129974	0
svgs/oxygen-icons-5.113.0/scalable/places/small/32x32/folder-print.svg	pass	176128	134606	41522	0
svgs/oxygen-icons-5.113.0/scalable/places/small/32x32/folder-red.svg	pass	242874	227960	14914	0
svgs/oxygen-icons-5.113.0/scalable/places/small/32x32/folder-remote.svg	pass	841285	457278	384007	0
svgs/oxygen-icons-5.113.0/scalable/places/small/32x32/folder-sound.svg	pass	585069	128640	456429	0
svgs/oxygen-icons-5.113.0/scalable/places/small/32x32/folder-tar.svg	pass	299126	126240	172886	0
svgs/oxygen-icons-5.113.0/scalable/places/small/32x32/folder-temp.svg	pass	136791	122475	14316	0
svgs/oxygen-icons-5.113.0/scalable/places/small/32x32/folder-txt.svg	pass	272690	131069	141621	0
svgs/oxygen-icons-5.113.0/scalable/places/small/32x32/folder-video.svg	pass	184431	135078	49353	0
svgs/oxygen-icons-5.113.0/scalable/places/small/32x32/folder-violet.svg	pass	133547	119953	13594	0
svgs/oxygen-icons-5.113.0/scalable/places/small/32x32/folder-yellow.svg	pass	366575	120284	246291	0
svgs/oxygen-icons-5.113.0/scalable/places/small/32x32/folder.svg	pass	133192	119980	13212	0
svgs/oxygen-icons-5.113.0/scalable/places/small/32x32/mail-folder-sent.svg	pass	203871	124644	79227	0
svgs/oxygen-icons-5.113.0/scalable/places/small/32x32/mail-message.svg	pass	66644	4222	62422	0
svgs/oxygen-icons-5.113.0/scalable/places/small/32x32/server-database.svg	pass	39289	20160	19129	0
svgs/oxygen-icons-5.113.0/scalable/places/small/32x32/user-home.svg	pass	139077	122599	16478	0
svgs/oxygen-icons-5.113.0/scalable/places/small/32x32/user-trash.svg	pass	61079	17957	43122	0
svgs/oxygen-icons-5.113.0/scalable/places/small/48x48/certificate-server.svg	pass	1276298	550452	725846	0
svgs/oxygen-icons-5.113.0/scalable/places/small/48x48/folder-activities.svg	pass	635582	133629	501953	0
svgs/oxygen-icons-5.113.0/scalable/places/small/48x48/folder-add.svg	pass	197715	125684	72031	0
svgs/oxygen-icons-5.113.0/scalable/places/small/48x48/folder-black.svg	pass	587486	120610	466876	0
svgs/oxygen-icons-5.113.0/scalable/places/small/48x48/folder-blue.svg	pass	372074	120977	251097	0
svgs/oxygen-icons-5.113.0/scalable/places/small/48x48/folder-bookmark.svg	pass	143294	125298	17996	0
svgs/oxygen-icons-5.113.0/scalable/places/small/48x48/folder-brown.svg	pass	135805	121296	14509	0
svgs/oxygen-icons-5.113.0/scalable/places/small/48x48/folder-cyan.svg	pass	252847	120558	132289	0
svgs/oxygen-icons-5.113.0/scalable/places/small/48x48/folder-development.svg	pass	547053	179726	367327	0
svgs/oxygen-icons-5.113.0/scalable/places/small/48x48/folder-documents.svg	pass	259309	132322	126987	0
svgs/oxygen-icons-5.113.0/scalable/places/small/48x48/folder-downloads.svg	pass	153768	130395	23373	0
svgs/oxygen-icons-5.113.0/scalable/places/small/48x48/folder-favorites.svg	mismatch	322452	167123	155329	5
svgs/oxygen-icons-5.113.0/scalable/places/small/48x48/folder-green.svg	pass	250543	121046	129497	0
svgs/oxygen-icons-5.113.0/scalable/places/small/48x48/folder-grey.svg	pass	370451	233309	137142	0
svgs/oxygen-icons-5.113.0/scalable/places/small/48x48/folder-html.svg	pass	889981	462437	427544	0
svgs/oxygen-icons-5.113.0/scalable/places/small/48x48/folder-image-people.svg	pass	830433	442386	388047	0
svgs/oxygen-icons-5.113.0/scalable/places/small/48x48/folder-image.svg	pass	605394	423083	182311	0
svgs/oxygen-icons-5.113.0/scalable/places/small/48x48/folder-important.svg	pass	408621	125809	282812	0
svgs/oxygen-icons-5.113.0/scalable/places/small/48x48/folder-locked.svg	pass	491083	257971	233112	0
svgs/oxygen-icons-5.113.0/scalable/places/small/48x48/folder-network.svg	pass	293664	133287	160377	0
svgs/oxygen-icons-5.113.0/scalable/places/small/48x48/folder-orange.svg	pass	483059	121314	361745	0
svgs/oxygen-icons-5.113.0/scalable/places/small/48x48/folder-print.svg	pass	243166	135777	107389	0
svgs/oxygen-icons-5.113.0/scalable/places/small/48x48/folder-red.svg	pass	585517	228932	356585	0
svgs/oxygen-icons-5.113.0/scalable/places/small/48x48/folder-remote.svg	pass	773183	459371	313812	0
svgs/oxygen-icons-5.113.0/scalable/places/small/48x48/folder-sound.svg	pass	217304	129930	87374	0
svgs/oxygen-icons-5.113.0/scalable/places/small/48x48/folder-tar.svg	pass	191679	133258	58421	0
svgs/oxygen-icons-5.113.0/scalable/places/small/48x48/folder-temp.svg	pass	137735	123005	14730	0
svgs/oxygen-icons-5.113.0/scalable/places/small/48x48/folder-txt.svg	pass	395908	239549	156359	0
svgs/oxygen-icons-5.113.0/scalable/places/small/48x48/folder-video.svg	pass	180294	138348	41946	0
svgs/oxygen-icons-5.113.0/scalable/places/small/48x48/folder-violet.svg	pass	253619	120828	132791	0
svgs/oxygen-icons-5.113.0/scalable/places/small/48x48/folder-yellow.svg	pass	251335	121447	129888	0
svgs/oxygen-icons-5.113.0/scalable/places/small/48x48/folder.svg	pass	134353	120930	13423	0
svgs/oxygen-icons-5.113.0/scalable/places/small/48x48/mail-folder-sent.svg	pass	202779	125477	77302	0
svgs/oxygen-icons-5.113.0/scalable/places/small/48x48/mail-message.svg	pass	65080	4092	60988	0
svgs/oxygen-icons-5.113.0/scalable/places/small/48x48/network-server-database.svg	pass	1522784	252653	1270131	0
svgs/oxygen-icons-5.113.0/scalable/places/small/48x48/network-workgroup.svg	pass	1367763	457090	910673	0
svgs/oxygen-icons-5.113.0/scalable/places/small/48x48/server-database.svg	pass	1516062	240716	1275346	0
svgs/oxygen-icons-5.113.0/scalable/places/small/48x48/user-home.svg	pass	138031	122797	15234	0
svgs/oxygen-icons-5.113.0/scalable/places/small/48x48/user-trash.svg	pass	64133	20612	43521	0
svgs/oxygen-icons-5.113.0/scalable/places/small/64x64/document-multiple.svg	pass	94290	10966	83324	0
svgs/oxygen-icons-5.113.0/scalable/places/small/64x64/folder-activities.svg	pass	179550	133929	45621	0
svgs/oxygen-icons-5.113.0/scalable/places/small/64x64/folder-black.svg	pass	472244	120717	351527	0
svgs/oxygen-icons-5.113.0/scalable/places/small/64x64/folder-blue.svg	pass	255368	120719	134649	0
svgs/oxygen-icons-5.113.0/scalable/places/small/64x64/folder-bookmark.svg	pass	141632	124176	17456	0
svgs/oxygen-icons-5.113.0/scalable/places/small/64x64/folder-brown.svg	pass	135108	120839	14269	0
svgs/oxygen-icons-5.113.0/scalable/places/small/64x64/folder-cyan.svg	pass	251462	120761	130701	0
svgs/oxygen-icons-5.113.0/scalable/places/small/64x64/folder-development.svg	pass	242087	179625	62462	0
svgs/oxygen-icons-5.113.0/scalable/places/small/64x64/folder-documents.svg	pass	176094	125653	50441	0
svgs/oxygen-icons-5.113.0/scalable/places/small/64x64/folder-downloads.svg	pass	154763	130243	24520	0
svgs/oxygen-icons-5.113.0/scalable/places/small/64x64/folder-favorites.svg	pass	213400	167019	46381	0
svgs/oxygen-icons-5.113.0/scalable/places/small/64x64/folder-green.svg	pass	368964	120547	248417	0
svgs/oxygen-icons-5.113.0/scalable/places/small/64x64/folder-grey.svg	pass	472185	229401	242784	0
svgs/oxygen-icons-5.113.0/scalable/places/small/64x64/folder-html.svg	pass	781570	463963	317607	0
svgs/oxygen-icons-5.113.0/scalable/places/small/64x64/folder-image-people.svg	pass	828937	441301	387636	0
svgs/oxygen-icons-5.113.0/scalable/places/small/64x64/folder-image.svg	pass	581892	416560	165332	0
svgs/oxygen-icons-5.113.0/scalable/places/small/64x64/folder-important.svg	pass	208204	125678	82526	0
svgs/oxygen-icons-5.113.0/scalable/places/small/64x64/folder-locked.svg	pass	379171	257884	121287	0
svgs/oxygen-icons-5.113.0/scalable/places/small/64x64/folder-network.svg	pass	182046	133226	48820	0
svgs/oxygen-icons-5.113.0/scalable/places/small/64x64/folder-orange.svg	pass	251204	120511	130693	0
svgs/oxygen-icons-5.113.0/scalable/places/small/64x64/folder-print.svg	pass	303654	143185	160469	0
svgs/oxygen-icons-5.113.0/scalable/places/small/64x64/folder-red.svg	pass	244520	228940	15580	0
svgs/oxygen-icons-5.113.0/scalable/places/small/64x64/folder-remote.svg	pass	773278	459343	313935	0
svgs/oxygen-icons-5.113.0/scalable/places/small/64x64/folder-sound.svg	pass	162572	135495	27077	0
svgs/oxygen-icons-5.113.0/scalable/places/small/64x64/folder-tar.svg	mismatch	191380	133160	58220	8
svgs/oxygen-icons-5.113.0/scalable/places/small/64x64/folder-temp.svg	pass	139965	124420	15545	0
svgs/oxygen-icons-5.113.0/scalable/places/small/64x64/folder-txt.svg	pass	156567	132043	24524	0
svgs/oxygen-icons-5.113.0/scalable/places/small/64x64/folder-video.svg	pass	204025	136913	67112	0
svgs/oxygen-icons-5.113.0/scalable/places/small/64x64/folder-violet.svg	pass	251061	120832	130229	0
svgs/oxygen-icons-5.113.0/scalable/places/small/64x64/folder-yellow.svg	pass	252254	121282	130972	0
svgs/oxygen-icons-5.113.0/scalable/places/small/64x64/folder.svg	pass	134602	120685	13917	0
svgs/oxygen-icons-5.113.0/scalable/places/small/64x64/mail-folder-sent.svg	pass	202920	125796	77124	0
svgs/oxygen-icons-5.113.0/scalable/places/small/64x64/mail-message.svg	pass	234028	5880	228148	0
svgs/oxygen-icons-5.113.0/scalable/places/small/64x64/network-server-database.svg	mismatch	833228	144012	689216	8
svgs/oxygen-icons-5.113.0/scalable/places/small/64x64/network-server.svg	pass	377035	229016	148019	0
svgs/oxygen-icons-5.113.0/scalable/places/small/64x64/network-workgroup.svg	pass	1118129	456573	661556	0
svgs/oxygen-icons-5.113.0/scalable/places/small/64x64/server-database.svg	mismatch	760194	132442	627752	8
svgs/oxygen-icons-5.113.0/scalable/places/small/64x64/user-home.svg	pass	142135	124554	17581	0
svgs/oxygen-icons-5.113.0/scalable/places/small/64x64/user-trash.svg	pass	60555	18054	42501	0
svgs/oxygen-icons-5.113.0/scalable/places/start-here-kde.svg	pass	20765	8245	12520	0
svgs/oxygen-icons-5.113.0/scalable/places/start-here.svg	pass	47385	12679	34706	3
svgs/oxygen-icons-5.113.0/scalable/places/user-desktop.svg	pass	228046	115148	112898	0
svgs/oxygen-icons-5.113.0/scalable/places/user-home.svg	pass	144510	124267	20243	0
svgs/oxygen-icons-5.113.0/scalable/places/user-identity.svg	pass	160309	27474	132835	0
svgs/oxygen-icons-5.113.0/scalable/places/user-trash.svg	pass	60534	18042	42492	0
svgs/oxygen-icons-5.113.0/scalable/special/small/16x16/zoom.svg	pass	14865	6917	7948	0
svgs/oxygen-icons-5.113.0/scalable/special/small/22x22/zoom.svg	pass	13959	6442	7517	0
svgs/oxygen-icons-5.113.0/scalable/status/audio-volume-high.svg	pass	15833	8192	7641	0
svgs/oxygen-icons-5.113.0/scalable/status/audio-volume-low.svg	pass	13859	7453	6406	0
svgs/oxygen-icons-5.113.0/scalable/status/audio-volume-medium.svg	pass	14149	7753	6396	0
svgs/oxygen-icons-5.113.0/scalable/status/audio-volume-muted.svg	pass	360017	20068	339949	0
svgs/oxygen-icons-5.113.0/scalable/status/battery-040.svg	pass	23215	11845	11370	0
svgs/oxygen-icons-5.113.0/scalable/status/battery-060.svg	pass	23943	12318	11625	0
svgs/oxygen-icons-5.113.0/scalable/status/battery-080.svg	pass	26502	12788	13714	0
svgs/oxygen-icons-5.113.0/scalable/status/battery-100.svg	pass	24109	11732	12377	0
svgs/oxygen-icons-5.113.0/scalable/status/battery-caution.svg	pass	22861	11575	11286	0
svgs/oxygen-icons-5.113.0/scalable/status/battery-charging-040.svg	pass	75952	14517	61435	0
svgs/oxygen-icons-5.113.0/scalable/status/battery-charging-060.svg	pass	76315	14989	61326	0
svgs/oxygen-icons-5.113.0/scalable/status/battery-charging-080.svg	pass	84149	15654	68495	0
svgs/oxygen-icons-5.113.0/scalable/status/battery-charging-caution.svg	pass	75597	14245	61352	0
svgs/oxygen-icons-5.113.0/scalable/status/battery-charging-low.svg	pass	60938	14776	46162	0
svgs/oxygen-icons-5.113.0/scalable/status/battery-charging.svg	pass	72776	16111	56665	0
svgs/oxygen-icons-5.113.0/scalable/status/battery-low.svg	pass	22487	11080	11407	0
svgs/oxygen-icons-5.113.0/scalable/status/battery-missing.svg	pass	132459	16443	116016	0
svgs/oxygen-icons-5.113.0/scalable/status/dialog-error.svg	pass	27367	10816	16551	0
svgs/oxygen-icons-5.113.0/scalable/status/dialog-information.svg	pass	118697	12307	106390	0
svgs/oxygen-icons-5.113.0/scalable/status/dialog-password.svg	pass	94091	47767	46324	0
svgs/oxygen-icons-5.113.0/scalable/status/dialog-warning.svg	pass	25838	10987	14851	0
svgs/oxygen-icons-5.113.0/scalable/status/folder-open.svg	pass	206571	4498	202073	0
svgs/oxygen-icons-5.113.0/scalable/status/hidef/user-trash-full.svg	pass	884366	138953	745413	0
svgs/oxygen-icons-5.113.0/scalable/status/image-loading.svg	pass	187318	55836	131482	0
svgs/oxygen-icons-5.113.0/scalable/status/image-missing.svg	pass	44737	15427	29310	4
svgs/oxygen-icons-5.113.0/scalable/status/mail-attachment.svg	pass	6647	2261	4386	0
svgs/oxygen-icons-5.113.0/scalable/status/mail-queued.svg	pass	29136	5672	23464	0
svgs/oxygen-icons-5.113.0/scalable/status/mail-read.svg	pass	107782	7704	100078	0
svgs/oxygen-icons-5.113.0/scalable/status/mail-replied.svg	pass	113671	8988	104683	0
svgs/oxygen-icons-5.113.0/scalable/status/mail-sent.svg	pass	30219	11498	18721	0
svgs/oxygen-icons-5.113.0/scalable/status/mail-tagged.svg	pass	27936	15309	12627	0
svgs/oxygen-icons-5.113.0/scalable/status/mail-task.svg	pass	62361	35611	26750	2
svgs/oxygen-icons-5.113.0/scalable/status/mail-unread-new.svg	pass	75588	9489	66099	0
svgs/oxygen-icons-5.113.0/scalable/status/mail-unread.svg	pass	33199	5245	27954	0
svgs/oxygen-icons-5.113.0/scalable/status/media-playlist-repeat.svg	pass	36777	15491	21286	0
svgs/oxygen-icons-5.113.0/scalable/status/media-playlist-shuffle.svg	pass	30655	16293	14362	0
svgs/oxygen-icons-5.113.0/scalable/status/object-locked.svg	pass	275209	181213	93996	0
svgs/oxygen-icons-5.113.0/scalable/status/object-unlocked.svg	pass	276159	181234	94925	0
svgs/oxygen-icons-5.113.0/scalable/status/printer-error.svg	pass	485216	283485	201731	1
svgs/oxygen-icons-5.113.0/scalable/status/printer-printing.svg	mismatch	479166	264998	214168	8
svgs/oxygen-icons-5.113.0/scalable/status/script-error.svg	pass	127095	58441	68654	0
svgs/oxygen-icons-5.113.0/scalable/status/security-high.svg	pass	22016	10800	11216	0
svgs/oxygen-icons-5.113.0/scalable/status/security-low.svg	pass	24309	11205	13104	0
svgs/oxygen-icons-5.113.0/scalable/status/security-medium.svg	pass	30801	11081	19720	0
svgs/oxygen-icons-5.113.0/scalable/status/small/16x16/audio-volume-high.svg	pass	21311	9164	12147	0
svgs/oxygen-icons-5.113.0/scalable/status/small/16x16/audio-volume-low.svg	pass	18543	7650	10893	0
svgs/oxygen-icons-5.113.0/scalable/status/small/16x16/audio-volume-medium.svg	pass	19905	8233	11672	0
svgs/oxygen-icons-5.113.0/scalable/status/small/16x16/audio-volume-muted.svg	pass	18562	7428	11134	0
svgs/oxygen-icons-5.113.0/scalable/status/small/16x16/battery-040.svg	pass	23215	11845	11370	0
svgs/oxygen-icons-5.113.0/scalable/status/small/16x16/battery-060.svg	pass	23943	12318	11625	0
svgs/oxygen-icons-5.113.0/scalable/status/small/16x16/battery-080.svg	pass	26502	12788	13714	0
svgs/oxygen-icons-5.113.0/scalable/status/small/16x16/battery-100.svg	pass	24109	11732	12377	0
svgs/oxygen-icons-5.113.0/scalable/status/small/16x16/battery-caution.svg	pass	22861	11575	11286	0
svgs/oxygen-icons-5.113.0/scalable/status/small/16x16/battery-charging-040.svg	pass	75952	14517	61435	0
svgs/oxygen-icons-5.113.0/scalable/status/small/16x16/battery-charging-060.svg	pass	76315	14989	61326	0
svgs/oxygen-icons-5.113.0/scalable/status/small/16x16/battery-charging-080.svg	pass	84149	15654	68495	0
svgs/oxygen-icons-5.113.0/scalable/status/small/16x16/battery-charging-caution.svg	pass	75597	14245	61352	0
svgs/oxygen-icons-5.113.0/scalable/status/small/16x16/battery-charging-low.svg	pass	60938	14776	46162	0
svgs/oxygen-icons-5.113.0/scalable/status/small/16x16/battery-low.svg	pass	22487	11080	11407	0
svgs/oxygen-icons-5.113.0/scalable/status/small/16x16/dialog-error.svg	pass	27232	10980	16252	0
svgs/oxygen-icons-5.113.0/scalable/status/small/16x16/dialog-information.svg	pass	107209	11396	95813	2
svgs/oxygen-icons-5.113.0/scalable/status/small/16x16/dialog-password.svg	pass	167498	48408	119090	0
svgs/oxygen-icons-5.113.0/scalable/status/small/16x16/dialog-warning.svg	pass	23422	9559	13863	0
svgs/oxygen-icons-5.113.0/scalable/status/small/16x16/folder-open.svg	pass	1076518	130806	945712	0
svgs/oxygen-icons-5.113.0/scalable/status/small/16x16/image-loading.svg	pass	186471	55124	131347	0
svgs/oxygen-icons-5.113.0/scalable/status/small/16x16/image-missing.svg	pass	201655	15538	186117	0
svgs/oxygen-icons-5.113.0/scalable/status/small/16x16/mail-attachment.svg	pass	5670	2175	3495	0
svgs/oxygen-icons-5.113.0/scalable/status/small/16x16/mail-queued.svg	pass	29141	5674	23467	0
svgs/oxygen-icons-5.113.0/scalable/status/small/16x16/mail-read.svg	pass	106463	7476	98987	0
svgs/oxygen-icons-5.113.0/scalable/status/small/16x16/mail-replied.svg	pass	18509	9241	9268	2
svgs/oxygen-icons-5.113.0/scalable/status/small/16x16/mail-unread-new.svg	pass	71962	9097	62865	0
svgs/oxygen-icons-5.113.0/scalable/status/small/16x16/mail-unread.svg	pass	32985	5388	27597	0
svgs/oxygen-icons-5.113.0/scalable/status/small/16x16/meeting-chair.svg	pass	86381	48764	37617	0
svgs/oxygen-icons-5.113.0/scalable/status/small/16x16/meeting-observer.svg	pass	264135	43614	220521	0
svgs/oxygen-icons-5.113.0/scalable/status/small/16x16/meeting-organizer.svg	pass	362980	157209	205771	0
svgs/oxygen-icons-5.113.0/scalable/status/small/16x16/meeting-participant-optional.svg	pass	88987	35327	53660	0
svgs/oxygen-icons-5.113.0/scalable/status/small/16x16/meeting-participant-reply.svg	pass	210434	146641	63793	0
svgs/oxygen-icons-5.113.0/scalable/status/small/16x16/meeting-participant.svg	pass	196767	138873	57894	0
svgs/oxygen-icons-5.113.0/scalable/status/small/16x16/object-locked.svg	pass	236546	149258	87288	0
svgs/oxygen-icons-5.113.0/scalable/status/small/16x16/object-unlocked.svg	pass	731595	480502	251093	0
svgs/oxygen-icons-5.113.0/scalable/status/small/16x16/security-high.svg	pass	17119	7479	9640	0
svgs/oxygen-icons-5.113.0/scalable/status/small/16x16/security-low.svg	pass	19987	8073	11914	0
svgs/oxygen-icons-5.113.0/scalable/status/small/16x16/security-medium.svg	pass	27611	7956	19655	0
svgs/oxygen-icons-5.113.0/scalable/status/small/16x16/task-accepted.svg	pass	42588	9007	33581	0
svgs/oxygen-icons-5.113.0/scalable/status/small/16x16/task-attempt.svg	pass	72463	5495	66968	0
svgs/oxygen-icons-5.113.0/scalable/status/small/16x16/task-attention.svg	pass	21501	10152	11349	0
svgs/oxygen-icons-5.113.0/scalable/status/small/16x16/task-complete.svg	pass	67681	5020	62661	0
svgs/oxygen-icons-5.113.0/scalable/status/small/16x16/task-delegate.svg	pass	55890	12442	43448	0
svgs/oxygen-icons-5.113.0/scalable/status/small/16x16/task-ongoing.svg	pass	44134	9615	34519	0
svgs/oxygen-icons-5.113.0/scalable/status/small/16x16/task-reject.svg	pass	78510	6518	71992	0
svgs/oxygen-icons-5.113.0/scalable/status/small/16x16/user-trash-full.svg	pass	292030	137661	154369	1
svgs/oxygen-icons-5.113.0/scalable/status/small/16x16/weather-freezing-rain.svg	pass	184007	88860	95147	0
svgs/oxygen-icons-5.113.0/scalable/status/small/16x16/window-suppressed.svg	pass	227865	22607	205258	0
svgs/oxygen-icons-5.113.0/scalable/status/small/22x22/audio-volume-high.svg	pass	10406	5193	5213	0
svgs/oxygen-icons-5.113.0/scalable/status/small/22x22/audio-volume-low.svg	pass	9822	4454	5368	0
svgs/oxygen-icons-5.113.0/scalable/status/small/22x22/audio-volume-medium.svg	pass	10115	4754	5361	0
svgs/oxygen-icons-5.113.0/scalable/status/small/22x22/audio-volume-muted.svg	pass	11429	4269	7160	0
svgs/oxygen-icons-5.113.0/scalable/status/small/22x22/battery-040.svg	pass	45919	18434	27485	0
svgs/oxygen-icons-5.113.0/scalable/status/small/22x22/battery-060.svg	pass	45919	18963	26956	0
svgs/oxygen-icons-5.113.0/scalable/status/small/22x22/battery-080.svg	pass	45918	19490	26428	0
svgs/oxygen-icons-5.113.0/scalable/status/small/22x22/battery-100.svg	pass	45918	20019	25899	0
svgs/oxygen-icons-5.113.0/scalable/status/small/22x22/battery-caution.svg	pass	45933	18768	27165	0
svgs/oxygen-icons-5.113.0/scalable/status/small/22x22/battery-charging-040.svg	pass	87487	11391	76096	0
svgs/oxygen-icons-5.113.0/scalable/status/small/22x22/battery-charging-060.svg	pass	87478	11912	75566	0
svgs/oxygen-icons-5.113.0/scalable/status/small/22x22/battery-charging-080.svg	pass	108653	12431	96222	0
svgs/oxygen-icons-5.113.0/scalable/status/small/22x22/battery-charging-caution.svg	pass	87516	11734	75782	0
svgs/oxygen-icons-5.113.0/scalable/status/small/22x22/battery-charging-low.svg	pass	87506	11203	76303	0
svgs/oxygen-icons-5.113.0/scalable/status/small/22x22/battery-charging.svg	pass	87469	12961	74508	0
svgs/oxygen-icons-5.113.0/scalable/status/small/22x22/battery-low.svg	pass	45928	18770	27158	0
svgs/oxygen-icons-5.113.0/scalable/status/small/22x22/battery-missing.svg	pass	433781	21335	412446	0
svgs/oxygen-icons-5.113.0/scalable/status/small/22x22/dialog-error.svg	pass	27287	11006	16281	0
svgs/oxygen-icons-5.113.0/scalable/status/small/22x22/dialog-information.svg	pass	44594	11368	33226	2
svgs/oxygen-icons-5.113.0/scalable/status/small/22x22/dialog-warning.svg	pass	25365	12502	12863	0
svgs/oxygen-icons-5.113.0/scalable/status/small/22x22/folder-open.svg	pass	144545	124574	19971	0
svgs/oxygen-icons-5.113.0/scalable/status/small/22x22/image-loading.svg	pass	187717	55867	131850	0
svgs/oxygen-icons-5.113.0/scalable/status/small/22x22/image-missing.svg	pass	41617	16242	25375	0
svgs/oxygen-icons-5.113.0/scalable/status/small/22x22/mail-attachment.svg	pass	5138	1973	3165	0
svgs/oxygen-icons-5.113.0/scalable/status/small/22x22/mail-queued.svg	pass	19580	5392	14188	0
svgs/oxygen-icons-5.113.0/scalable/status/small/22x22/mail-read.svg	pass	108098	8473	99625	0
svgs/oxygen-icons-5.113.0/scalable/status/small/22x22/mail-unread-new.svg	pass	76503	10022	66481	0
svgs/oxygen-icons-5.113.0/scalable/status/small/22x22/mail-unread.svg	pass	33244	5756	27488	0
svgs/oxygen-icons-5.113.0/scalable/status/small/22x22/meeting-chair.svg	pass	212943	145175	67768	0
svgs/oxygen-icons-5.113.0/scalable/status/small/22x22/meeting-observer.svg	pass	263415	47602	215813	0
svgs/oxygen-icons-5.113.0/scalable/status/small/22x22/meeting-organizer.svg	pass	212609	156927	55682	0
svgs/oxygen-icons-5.113.0/scalable/status/small/22x22/meeting-participant-optional.svg	pass	268423	39037	229386	0
svgs/oxygen-icons-5.113.0/scalable/status/small/22x22/meeting-participant-reply.svg	pass	401411	151158	250253	0
svgs/oxygen-icons-5.113.0/scalable/status/small/22x22/meeting-participant.svg	pass	195110	142773	52337	0
svgs/oxygen-icons-5.113.0/scalable/status/small/22x22/object-locked.svg	pass	263401	170174	93227	0
svgs/oxygen-icons-5.113.0/scalable/status/small/22x22/object-unlocked.svg	pass	259582	169206	90376	0
svgs/oxygen-icons-5.113.0/scalable/status/small/22x22/task-accepted.svg	pass	42947	9251	33696	0
svgs/oxygen-icons-5.113.0/scalable/status/small/22x22/task-attempt.svg	pass	69506	5874	63632	0
svgs/oxygen-icons-5.113.0/scalable/status/small/22x22/task-attention.svg	pass	21498	10119	11379	0
svgs/oxygen-icons-5.113.0/scalable/status/small/22x22/task-complete.svg	pass	79586	6510	73076	0
svgs/oxygen-icons-5.113.0/scalable/status/small/22x22/task-delegate.svg	pass	55936	12972	42964	0
svgs/oxygen-icons-5.113.0/scalable/status/small/22x22/task-ongoing.svg	pass	44367	9927	34440	0
svgs/oxygen-icons-5.113.0/scalable/status/small/22x22/task-reject.svg	pass	80061	6584	73477	0
svgs/oxygen-icons-5.113.0/scalable/status/small/22x22/user-trash-full.svg	pass	292089	137714	154375	0
svgs/oxygen-icons-5.113.0/scalable/status/small/22x22/weather-hail.svg	pass	578799	301116	277683	0
svgs/oxygen-icons-5.113.0/scalable/status/small/22x22/weather-showers-day.svg	mismatch	562171	209180	352991	8
svgs/oxygen-icons-5.113.0/scalable/status/small/22x22/weather-showers-night.svg	pass	1906817	1051608	855209	0
svgs/oxygen-icons-5.113.0/scalable/status/small/22x22/weather-showers.svg	pass	503776	169036	334740	0
svgs/oxygen-icons-5.113.0/scalable/status/small/22x22/weather-snow-rain.svg	pass	597070	188206	408864	0
svgs/oxygen-icons-5.113.0/scalable/status/small/22x22/weather-snow-scattered-day.svg	pass	451372	218564	232808	0
svgs/oxygen-icons-5.113.0/scalable/status/small/22x22/weather-snow-scattered-night.svg	pass	1928434	1061614	866820	0
svgs/oxygen-icons-5.113.0/scalable/status/small/22x22/weather-snow-scattered.svg	pass	460214	181148	279066	0
svgs/oxygen-icons-5.113.0/scalable/status/small/22x22/weather-snow.svg	pass	482181	190359	291822	0
svgs/oxygen-icons-5.113.0/scalable/status/small/22x22/window-suppressed.svg	pass	213822	22680	191142	0
svgs/oxygen-icons-5.113.0/scalable/status/small/32x32/dialog-information.svg	pass	118697	12307	106390	0
svgs/oxygen-icons-5.113.0/scalable/status/small/32x32/folder-open.svg	pass	341285	129131	212154	0
svgs/oxygen-icons-5.113.0/scalable/status/small/32x32/meeting-chair.svg	pass	212929	145211	67718	0
svgs/oxygen-icons-5.113.0/scalable/status/small/32x32/meeting-observer.svg	pass	263416	47581	215835	0
svgs/oxygen-icons-5.113.0/scalable/status/small/32x32/meeting-organizer.svg	pass	352092	157218	194874	0
svgs/oxygen-icons-5.113.0/scalable/status/small/32x32/meeting-participant-optional.svg	pass	105523	39211	66312	0
svgs/oxygen-icons-5.113.0/scalable/status/small/32x32/meeting-participant-reply.svg	pass	245668	153053	92615	0
svgs/oxygen-icons-5.113.0/scalable/status/small/32x32/meeting-participant.svg	pass	195092	142762	52330	0
svgs/oxygen-icons-5.113.0/scalable/status/small/32x32/task-accepted.svg	pass	46536	8957	37579	0
svgs/oxygen-icons-5.113.0/scalable/status/small/32x32/task-attempt.svg	pass	70453	5734	64719	0
svgs/oxygen-icons-5.113.0/scalable/status/small/32x32/task-attention.svg	pass	21455	10105	11350	0
svgs/oxygen-icons-5.113.0/scalable/status/small/32x32/task-complete.svg	pass	69783	6279	63504	0
svgs/oxygen-icons-5.113.0/scalable/status/small/32x32/task-delegate.svg	pass	55872	12931	42941	0
svgs/oxygen-icons-5.113.0/scalable/status/small/32x32/task-ongoing.svg	pass	53659	9929	43730	0
svgs/oxygen-icons-5.113.0/scalable/status/small/32x32/task-reject.svg	pass	79553	6806	72747	1
svgs/oxygen-icons-5.113.0/scalable/status/small/32x32/user-trash-full.svg	pass	291979	137634	154345	0
svgs/oxygen-icons-5.113.0/scalable/status/small/32x32/weather-clouds-night.svg	pass	1880062	1031302	848760	0
svgs/oxygen-icons-5.113.0/scalable/status/small/32x32/weather-clouds.svg	pass	410486	188819	221667	1
svgs/oxygen-icons-5.113.0/scalable/status/small/32x32/weather-freezing-rain.svg	pass	801699	93688	708011	0
svgs/oxygen-icons-5.113.0/scalable/status/small/32x32/weather-hail.svg	pass	578797	301120	277677	0
svgs/oxygen-icons-5.113.0/scalable/status/small/32x32/weather-showers-day.svg	mismatch	633815	209185	424630	5
svgs/oxygen-icons-5.113.0/scalable/status/small/32x32/weather-showers-night.svg	pass	1906804	1051614	855190	0
svgs/oxygen-icons-5.113.0/scalable/status/small/32x32/weather-showers-scattered-day.svg	pass	434902	205255	229647	1
svgs/oxygen-icons-5.113.0/scalable/status/small/32x32/weather-showers-scattered-night.svg	pass	1903041	1047979	855062	0
svgs/oxygen-icons-5.113.0/scalable/status/small/32x32/weather-showers-scattered.svg	pass	337259	166935	170324	0
svgs/oxygen-icons-5.113.0/scalable/status/small/32x32/weather-showers.svg	pass	343216	170860	172356	0
svgs/oxygen-icons-5.113.0/scalable/status/small/32x32/weather-snow-rain.svg	pass	592715	188236	404479	0
svgs/oxygen-icons-5.113.0/scalable/status/small/32x32/weather-snow-scattered-day.svg	pass	675958	219470	456488	0
svgs/oxygen-icons-5.113.0/scalable/status/small/32x32/weather-snow-scattered-night.svg	pass	1928401	1061660	866741	0
svgs/oxygen-icons-5.113.0/scalable/status/small/32x32/weather-snow-scattered.svg	pass	460866	181155	279711	0
svgs/oxygen-icons-5.113.0/scalable/status/small/32x32/weather-snow.svg	pass	493066	194986	298080	0
svgs/oxygen-icons-5.113.0/scalable/status/small/48x48/audio-volume-high.svg	pass	18497	8846	9651	0
svgs/oxygen-icons-5.113.0/scalable/status/small/48x48/audio-volume-low.svg	pass	18134	8107	10027	0
svgs/oxygen-icons-5.113.0/scalable/status/small/48x48/audio-volume-medium.svg	pass	18387	8407	9980	0
svgs/oxygen-icons-5.113.0/scalable/status/small/48x48/audio-volume-muted.svg	pass	377830	20380	357450	0
svgs/oxygen-icons-5.113.0/scalable/status/small/48x48/dialog-error.svg	pass	27247	10675	16572	0
svgs/oxygen-icons-5.113.0/scalable/status/small/48x48/dialog-information.svg	pass	43862	10915	32947	3
svgs/oxygen-icons-5.113.0/scalable/status/small/48x48/dialog-warning.svg	pass	25146	12065	13081	0
svgs/oxygen-icons-5.113.0/scalable/status/small/48x48/folder-open.svg	pass	378522	128980	249542	0
svgs/oxygen-icons-5.113.0/scalable/status/small/48x48/mail-queued.svg	pass	27998	5053	22945	0
svgs/oxygen-icons-5.113.0/scalable/status/small/48x48/meeting-chair.svg	pass	220983	144453	76530	0
svgs/oxygen-icons-5.113.0/scalable/status/small/48x48/meeting-observer.svg	pass	263369	47299	216070	0
svgs/oxygen-icons-5.113.0/scalable/status/small/48x48/meeting-organizer.svg	pass	234611	156614	77997	0
svgs/oxygen-icons-5.113.0/scalable/status/small/48x48/meeting-participant-optional.svg	pass	234588	40496	194092	1
svgs/oxygen-icons-5.113.0/scalable/status/small/48x48/meeting-participant-reply.svg	pass	343723	154707	189016	0
svgs/oxygen-icons-5.113.0/scalable/status/small/48x48/meeting-participant.svg	pass	211557	143807	67750	0
svgs/oxygen-icons-5.113.0/scalable/status/small/48x48/task-accepted.svg	pass	47461	8942	38519	0
svgs/oxygen-icons-5.113.0/scalable/status/small/48x48/task-attempt.svg	pass	64751	5694	59057	0
svgs/oxygen-icons-5.113.0/scalable/status/small/48x48/task-attention.svg	pass	21753	9984	11769	0
svgs/oxygen-icons-5.113.0/scalable/status/small/48x48/task-complete.svg	pass	83398	6462	76936	0
svgs/oxygen-icons-5.113.0/scalable/status/small/48x48/task-delegate.svg	pass	60664	12845	47819	0
svgs/oxygen-icons-5.113.0/scalable/status/small/48x48/task-ongoing.svg	pass	53535	9968	43567	2
svgs/oxygen-icons-5.113.0/scalable/status/small/48x48/task-reject.svg	pass	89695	6082	83613	0
svgs/oxygen-icons-5.113.0/scalable/status/small/48x48/user-trash-full.svg	pass	292909	137625	155284	0
svgs/oxygen-icons-5.113.0/scalable/status/small/64x64/user-trash-full.svg	pass	291481	137736	153745	0
svgs/oxygen-icons-5.113.0/scalable/status/update-high.svg	pass	17584	6800	10784	0
svgs/oxygen-icons-5.113.0/scalable/status/update-low.svg	pass	17751	7238	10513	0
svgs/oxygen-icons-5.113.0/scalable/status/update-medium.svg	pass	17598	6800	10798	0
svgs/oxygen-icons-5.113.0/scalable/status/update-none.svg	pass	15593	5608	9985	0
svgs/oxygen-icons-5.113.0/scalable/status/user-away-extended.svg	pass	14074	4838	9236	0
svgs/oxygen-icons-5.113.0/scalable/status/user-away.svg	pass	13075	4329	8746	0
svgs/oxygen-icons-5.113.0/scalable/status/user-busy.svg	mismatch	7160	2200	4960	8
svgs/oxygen-icons-5.113.0/scalable/status/user-invisible.svg	pass	8548	3417	5131	2
svgs/oxygen-icons-5.113.0/scalable/status/user-offline.svg	pass	6435	2396	4039	4
svgs/oxygen-icons-5.113.0/scalable/status/user-online.svg	mismatch	5633	1986	3647	8
svgs/oxygen-icons-5.113.0/scalable/status/user-trash-full.svg	pass	291324	137728	153596	0
svgs/oxygen-icons-5.113.0/scalable/status/wallet-closed.svg	pass	7286	2781	4505	0
svgs/oxygen-icons-5.113.0/scalable/status/wallet-open.svg	pass	9902	5085	4817	0
svgs/oxygen-icons-5.113.0/scalable/status/weather-clear-night.svg	pass	1607224	881831	725393	4
svgs/oxygen-icons-5.113.0/scalable/status/weather-clear.svg	pass	67144	38562	28582	0
svgs/oxygen-icons-5.113.0/scalable/status/weather-clouds-night.svg	pass	1847482	1015239	832243	2
svgs/oxygen-icons-5.113.0/scalable/status/weather-clouds.svg	pass	309383	172694	136689	0
svgs/oxygen-icons-5.113.0/scalable/status/weather-few-clouds-night.svg	pass	2457642	1329541	1128101	0
svgs/oxygen-icons-5.113.0/scalable/status/weather-few-clouds.svg	pass	905052	472262	432790	0
svgs/oxygen-icons-5.113.0/scalable/status/weather-freezing-rain.svg	pass	845637	123192	722445	0
svgs/oxygen-icons-5.113.0/scalable/status/weather-hail.svg	pass	420983	210307	210676	0
svgs/oxygen-icons-5.113.0/scalable/status/weather-many-clouds.svg	pass	709165	395108	314057	0
svgs/oxygen-icons-5.113.0/scalable/status/weather-mist.svg	pass	4173557	2256106	1917451	0
svgs/oxygen-icons-5.113.0/scalable/status/weather-none-available.svg	pass	13796	5165	8631	0
svgs/oxygen-icons-5.113.0/scalable/status/weather-showers-day.svg	pass	507897	293369	214528	0
svgs/oxygen-icons-5.113.0/scalable/status/weather-showers-night.svg	pass	2852706	1134465	1718241	0
svgs/oxygen-icons-5.113.0/scalable/status/weather-showers-scattered-day.svg	pass	485820	228761	257059	0
svgs/oxygen-icons-5.113.0/scalable/status/weather-showers-scattered-night.svg	pass	2007695	1072089	935606	0
svgs/oxygen-icons-5.113.0/scalable/status/weather-showers-scattered.svg	pass	421185	216796	204389	0
svgs/oxygen-icons-5.113.0/scalable/status/weather-showers.svg	pass	485471	252537	232934	0
svgs/oxygen-icons-5.113.0/scalable/status/weather-snow-rain.svg	pass	1087109	469123	617986	1
svgs/oxygen-icons-5.113.0/scalable/status/weather-snow-scattered-day.svg	pass	1357024	583739	773285	0
svgs/oxygen-icons-5.113.0/scalable/status/weather-snow-scattered-night.svg	pass	2564612	1426154	1138458	0
svgs/oxygen-icons-5.113.0/scalable/status/weather-snow-scattered.svg	pass	1063842	546716	517126	0
svgs/oxygen-icons-5.113.0/scalable/status/weather-snow.svg	pass	1870664	1032924	837740	0
svgs/oxygen-icons-5.113.0/scalable/status/weather-storm-day.svg	pass	3205033	1317728	1887305	0
svgs/oxygen-icons-5.113.0/scalable/status/weather-storm-night.svg	pass	4045289	2161675	1883614	0
svgs/oxygen-icons-5.113.0/scalable/status/weather-storm.svg	pass	2283553	1280223	1003330	0
svgs/oxygen-icons-5.113.0/scalable/status/window-suppressed.svg	pass	63071	15393	47678	0
svgs/oxygen-icons-5.113.0/scalable/text-formatting.svg	mismatch	609457	343515	265942	11